abaestu	wave down; hang down richly (poet.);
abalien	make alien; separate, abstract; alienate, estrange, make disaffected;
abalien	|transfer (sale/contract); remove, take away, dispose of; numb/deaden;
abambul	go away;
abbatiz	be abbot;
abbrevi	shorten, cut off; abbreviate, abstract; epitomize (Souter); break off; weaken;
abdic	resign, abdicate; abolish; disinherit; renounce, reject, expel, disapprove of;
abequit	ride away;
aberr	stray, wander, deviate; go/be/do wrong; be unfaithful; escape; disagree (with);
abit	go away, depart;
abject	throw/cast away/down/aside; abandon; slight; humble; debase; sell too cheaply;
abjudic	deprive by judicial verdict; give judgment against; reject; deny an oath;
abjug	separate (from), remove; loose from the yoke;
abjurg	take away in settlement of a quarrel; deny/refuse reproachfully (L+S);
abjur	repudiate (obligation or duty); deny on oath (falsely); abjure; perjure;
ablact	wean;
ablacu	loosen/weed the soil at the roots (of trees);
ablacu	loosen/weed the soil at the roots (of trees);
ablaque	loosen/weed the soil at the roots (of trees);
ableg	send away/off (on a mission); banish, get rid of; remove/delete a word;
abloc	place a contract for (work), hire; let/lease/rent (house);
abnat	swim away from; swim off;
abneg	deny; decline (to), refuse, reject; refuse to give, withhold (what is due);
abnoct	spend the night out, stay away all night; spend the night away from Rome;
abnod	cut off knots; clear trees of knots;
abnumer	count up, reckon up;
abnut	deny/refuse/forbid (w/shake of head) repeatedly; forbid;
abort	cast its young (beast) (give birth prematurely);
abrenunti	renounce, repudiate (strongly);
abrog	abolish; repeal wholly, annul; remove, take away;
absent	send away, cause one to be absent; be absent;
abson	have harsh/discordant/unpleasant sound;
abst	stand at a distance, stand off; keep at a distance;
abund	abound (in), have in large measure; overdo, exceed; overflow; be rich/numerous;
accapit	admit subservience; acknowledge feudal liability;
acceler	speed up, quicken, hurry; make haste, act quickly, hasten; accelerate;
accept	receive regularly, take (payment/food); be given (name); submit to; grasp idea;
accessit	approach repeatedly; keep on coming;
accipitr	tear, rend (like a hawk);
acclam	shout (at), cry out against, protest; shout approval, applaud;
acclar	make clear, reveal, make manifest;
acclin	lay down, rest (on) (w/DAT), lean against/towards, incline (to);
accommod	adapt, adjust to, fit, suit; apply to, fasten on; apply/devote oneself to;
accomod	adapt, adjust to, fit, suit; apply to, fasten on; apply/devote oneself to;
acconger	bear, bring forth;
accord	agree with; harmonize;
accorpor	incorporate, fit/join to;
accub	lie near or by; recline at table;
accumul	accumulate, heap/pile up/soil; add by exaggeration; add, increase, enhance;
accur	take care of, attend to (duties/guests), give attention to; perform with care;
accusit	accuse repeatedly; go on accusing;
accus	accuse, blame, find fault, impugn; reprimand; charge (w/crime/offense);
accuss	accuse, blame, find fault, impugn; reprimand; charge (w/crime/offense);
acerb	embitter; aggravate; make disagreeable; make worse;
acerv	heap/pile up; make into heaps/piles; massed/categorized together; cover with;
acetasc	become sour/vinegary;
acontiz	shoot a dart; spout/gush forth (blood);
actit	act/plead frequently/repeatedly; take parts in play as actor, be actor in;
actu	implement; actuate;
acumin	sharpen, make pointed, cut to a point;
adaequ	equalize, make equal in height, come up to level; compare (to); be equal; raze;
adaer	calculate the area of a piece of land, appraise, value (in money), estimate;
adaestu	rush, roar, boil up;
adagger	heap (earth, etc.) up around/over; seethe, foam up;
adallig	bind/fasten to, attach;
adambul	walk beside/near;
adam	fall in love/lust with; love passionately/adulterously; admire greatly; covet;
adampli	enlarge, increase, widen; embellish;
adapt	adjust, modify; fit (to) (w/DAT);
adar	plow carefully;
adauct	increase, add to the resources of;
adbell	make war upon;
adblater	prattle, chatter;
adbrevi	shorten, cut off; abbreviate, abstract; epitomize (Souter); break off; weaken;
adceler	speed up, quicken, hurry; make haste, act quickly, hasten; accelerate;
adclam	shout (at), cry out against, protest; shout approval, applaud;
adclar	make clear, reveal, make manifest;
adclin	lay down, rest (on) (w/DAT), lean against/towards, incline (to);
adcommod	adapt, adjust to, fit, suit; apply to, fasten on; apply/devote oneself to;
adcumul	accumulate, heap/pile up/soil; add by exaggeration; add, increase, enhance;
adcur	take care of, attend to (duties/guests), give attention to; perform with care;
addecim	take the tenth part/a tenth; tithe;
addens	thicken, make more dense;
addivin	prognosticate, divine;
addubit	doubt, be doubtful/uncertain; hesitate (to), hesitate over a situation;
adequit	ride up to/towards/near, gallop up;
aderr	stray towards/near; wander to/by;
adesc	feed; fatten;
adfigur	form (word) by analogy;
adfirm	affirm/assert (dogmatically/positively); confirm, ratify, restore; emphasize;
adflect	affect, move, influence (to a course of action);
adflict	shatter, damage, strike repeatedly, buffet, wreck; oppress, afflict; vex;
adfl	blow/breathe (on/towards); inspire, infuse; waft; graze; breathe poison on;
adformid	be afraid, fear;
adfric	rub (one thing against another); apply/communicate/impart by rubbing, smear on;
adfric	rub (one thing against another); apply/communicate/impart by rubbing, smear on;
adfri	sprinkle (powder); crumble, grate;
adgener	beget in addition;
adger	heap/fill up, bring, carry; increase, add fuel; push/crowd/press together;
adglomer	gather into a body, mass together, join forces; pile up in masses; agglomerate;
adglutin	glue/stick/adhere/fasten to/together; fit/grip on closely; bring in contact;
adgrav	aggravate, exaggerate; weigh down, oppress; make heavier; embarrass further;
adgreg	collect, include, group, implicate; (cause to) flock/join together, attach;
adgubern	steer (one's course);
adhal	breathe upon;
adham	catch, secure;
adhospit	entertain as guest; propitiate;
adinfl	swell up;
adinspect	watch; guard (person);
adit	approach often/frequently/habitually;
adjudic	adjudge, impute, attribute, ascribe (to); award (as a judge), assign (to);
adjug	join, attach (to);
adjur	swear by/solemnly; affirm with oath; charge/entreat/urge (as under oath/curse);
adjuv	help, aid, abet, encourage, favor; cherish, sustain; be of use, be profitable;
adjuv	help, aid, abet, encourage, favor; cherish, sustain; be of use, be profitable;
adlabor	make a special effort; take trouble to;
adlacrim	shed tears, cry, weep (at or as an accompaniment to something);
adlatr	bark at; rail at; rage, roar (sea);
adlaud	praise, commend;
adlav	flow up to (water), wash;
adlect	entice, allure, encourage, invite;
adleg	depute/send as agent, commission, put up; suborn; urge/plea, lay before; allege;
adlevi	lighten, make light; deal lightly/leniently with; raise up, relieve;
adlev	lift/raise/heap/pile up, exalt; alleviate/diminish/weaken; comfort/console/cheer
adlev	|smooth, smooth off, make smooth; polish; depilate;
adlig	bind/fetter (to); bandage; hinder, impede, detain; accuse; implicate/involve in;
adludi	play/frolic (with);
admatur	hasten (an occurrence); bring to maturity, mature, ripen;
adme	go to, approach;
admigr	go and live with; go to a place; come to; be added to;
administr	administer, manage, direct; assist; operate, conduct; maneuver (ship); bestow;
admulc	stroke;
admutil	cut/clip close; shave; fleece, cheat, defraud;
adnarr	tell/relate (to);
adnat	swim to/up to; swim beside/alongside;
adnavig	sail to/up to/towards; sail beside/alongside;
adneg	refuse; withhold;
adnict	wink to/at; blink at;
adnihil	annihilate, destroy, demolish, ruin, bring to nothing;
adnilil	annihilate, bring to nothing;
adn	swim to/towards, approach by swimming; sail to/towards; brought by sea (goods);
adnod	cut (shoot) right back, cut flush; cut off knots, cut away suckers;
adnot	note/jot down, notice, become aware; mark, annotate; record, state; designate;
adnubil	bring up clouds (against);
adnull	annihilate, obliterate, destroy; annul (eccl.);
adnumer	count (in/out), pay; reckon (time); enumerate, run through; classify as; add;
adnunti	announce, say, make known; report, bring news; prophesy/announce before; preach;
adnut	nod (to); order/assent to by a nod; bow to;
adopt	adopt, select, secure, pick out; wish/name for oneself; adopt legally;
adordin	set in order, arrange;
adorn	equip, get ready, prepare; set off; adorn, array, embellish; honor, endow;
ador	honor, adore, worship, pay homage, reverence; beg, plead with, appeal to;
adpar	prepare, fit out, make ready, equip, provide; attempt; organize (project);
adpector	press/clasp to the breast;
adpellit	call or name (frequently or habitually);
adpell	call (upon); address; dun; solicit; appeal (to); bring to court; accuse; name;
adplic	connect, place near, bring into contact; land (ship); adapt; apply/devote to;
adplic	connect, place near, bring into contact; land (ship); adapt; apply/devote to;
adplor	lament, weep at/on account of; deplore (thing);
adplumb	solder, solder on, affix by soldering, close/seal by soldering/with solder;
adport	carry/convey/bring (to); import; present (play); bring (news); make one's way;
adpostul	beg/entreaty/solicit importunately/persistently/troublesomely/pressingly;
adprens	snatch at;
adpreti	value, set/estimate a price, appraise; purchase, buy; appropriate to one's self;
adprob	approve, commend, endorse; prove; confirm; justify; allow; make good;
adpron	lean forwards;
adproper	hasten, hurry, come hastily, make haste; accelerate, speed up;
adpropinqu	approach (w/DAT or ad+ACC); come near to, draw near/nigh (space/time); be close;
adpropi	approach (w/DAT or ad+ACC); come near to, draw near/nigh (space/time); be close;
adpropri	appropriate, make one's own;
adproxim	be/draw/come close/near to, approach;
adpugn	attack, assault;
adquiet	discharge (a debt);
adremig	row up to/towards;
adrig	water (plants), moisten the soil around;
adrog	ask, question; arrogate to one's self, claim, make undue claim; confer (upon);
adrog	|adopt (an adult) as one's son (esp. at his instance);
adror	moisten, bedew;
adserv	keep, guard, preserve; watch, observe; keep in custody; save life of, rescue;
adsever	act earnestly; assert strongly/emphatically, declare; profess; be serious;
adsibil	hiss out (breath) upon (w/DAT);
adsicc	dry, dry out, dry up, make dry;
adsidu	apply constantly; make constant use of (Souter); use regularly/incessantly;
adsignific	show (w/ACC + INF), make evident; mean/denote (words);
adsign	assign, distribute, allot; award, bestow (rank/honors); impute; affix seal;
adsimil	make like; compare; counterfeit, simulate, imitate, pretend, feign, act a part;
adsimul	make like; compare; counterfeit, simulate, imitate, pretend, feign, act a part;
adsoci	join (to), associate (with);
adsol	level to the ground, destroy;
adson	respond, reply; sound in accompaniment; sing as an accompaniment;
adspect	look/gaze at/upon; observe, watch; pay heed; face/look towards (place/person);
adspir	breathe/blow (upon); aspirate; instill, infuse; be fragrant; influence; aspire;
adst	stand at/on/by/near; assist; stand up/upright/waiting/still/on one's feet;
adst	stand at/on/by/near; assist; stand up/upright/waiting/still/on one's feet;
adstrangul	strangle;
adsult	jump/leap at/towards/upon; dash against; attack, assault, make an attack (on);
adsuspir	sigh in response (to) (w/DAT);
adtemper	fit, adjust;
adtempt	attack, assail; call into question; try to seduce/use; make an attempt on, try;
adtent	attack, assail; call into question; try to seduce/use; make an attempt on, try;
adtenu	thin (out); weaken, lessen, diminish, shrink, reduce in size; make plain;
adtermin	set bounds to, measure, limit;
adtill	tickle, please;
adtitul	name, entitle;
adtoler	support, sustain, bear;
adton	strike with lightning, blast; drive crazy, distract;
adtract	touch; lay hands on; handle (roughly), assault (sexually), violate; deal with;
adtrect	touch; lay hands on; handle (roughly), assault (sexually), violate; deal with;
adtrepid	bestir oneself;
adtribul	thresh, press hard;
adtumul	heap up against; bank up (with something);
adulter	commit adultery, defile (w/adultery); falsify, counterfeit, debase, corrupt;
adumbr	sketch out, silhouette, outline, represent; shade, screen, obscure; feign;
adun	unite, make one;
advect	import, bring (merchandise/goods) from abroad;
advel	cover, veil;
advent	approach, come to, draw near; arrive, turn up; come in (tide); approximate;
adverber	beat upon; strike against;
advigil	watch by/over; take care; be on watch, be vigilant;
advoc	call, summon, invite, convoke, call for; call in as counsel; invoke the Gods;
advol	fly to, dash to (w/DAT or ad + ACC), hasten towards;
aedific	build, erect, construct, make; create; establish; improve; edify;
aeditu	act as sacristan, be in charge/take care of temple;
aegrot	be sick; be distressed/mentally/morally ill, be afflicted, languish, grieve;
aequidist	be at equal distance;
aequilibr	keep in a state of equilibrium/balance;
aequipar	become/put on a equal/level with/to, rival, equal; equalize; compare, liken;
aequiper	become/put on a equal/level with/to, rival, equal; equalize; compare, liken;
aequ	level, make even/straight; equal; compare; reach as high or deep as;
aerugin	rust, become rusty; become cankered;
aerusc	beg; go begging; get money traveling and practicing juggling/legerdemain (L+S);
aestim	value, assess; estimate; reckon; consider, judge (situation); esteem;
aestiv	spend/pass the summer;
aestum	value, assess; estimate; reckon; consider, judge (situation); esteem;
aestu	boil, seethe, foam; billow roll in waves; be agitated/hot; burn; waver;
aetern	immortalize; confer undying fame on;
affigur	form (word) by analogy;
affirm	affirm/assert (dogmatically/positively); confirm, ratify, restore; emphasize;
afflect	affect, move, influence (to a course of action);
afflict	shatter, damage, strike repeatedly, buffet, wreck; oppress, afflict; vex;
affl	blow/breathe (on/towards); inspire, infuse; waft; graze; breathe poison on;
afformid	be afraid, fear;
affric	rub (one thing against another); apply/communicate/impart by rubbing, smear on;
affric	rub (one thing against another); apply/communicate/impart by rubbing, smear on;
affri	sprinkle (powder); crumble, grate;
aget	stir/drive/shake/move about; revolve; live; control, ride; consider, pursue;
aggener	beget in addition;
agger	heap/fill up, bring, carry; increase, add fuel; push/crowd/press together;
agglomer	gather into a body, mass together, join forces; pile up in masses; agglomerate;
agglutin	glue/stick/adhere/fasten to/together; fit/grip on closely; bring in contact;
aggrav	aggravate, exaggerate; weigh down, oppress; make heavier; embarrass further;
aggreg	collect, include, group, implicate; (cause to) flock/join together, attach;
aggubern	steer (one's course);
agin	move heaven and earth, do one's best by hook or crook;
agit	stir/drive/shake/move about; revolve; live; control, ride; consider, pursue;
agnomin	give/honor with a nickname/additional name denoting achievement/characteristic;
agoni	struggle/fight (against); strive unto death (Vulgate Sirach 4:33);
agoniz	dispute; struggle/fight (against);
alb	make white;
allabor	make a special effort; take trouble to;
allacrim	shed tears, cry, weep (at or as an accompaniment to something);
allatr	bark at; rail at; rage, roar (sea);
allaud	praise, commend;
allav	flow up to (water), wash;
allect	entice, allure, encourage, invite;
alleg	depute/send as agent, commission; put up, suborn; urge/plea, lay before; allege;
allegoriz	allegorize, speak in allegories;
allevi	lighten, make light; deal lightly/leniently with; raise up, relieve;
allev	lift/raise/heap/pile up, exalt; alleviate/diminish/weaken; comfort/console/cheer
allev	|smooth, smooth off, make smooth; polish; depilate;
allig	bind/fetter (to); bandage; hinder, impede, detain; accuse; implicate/involve in;
alloc	stow; hire; let;
alludi	play/frolic (with);
altern	do by turns, vary; alternate, waver, ebb and flow; bear/crop in alternate years;
alt	raise, make high, elevate;
amand	send away, dismiss, banish; regulate;
ambul	walk, take a walk, go on foot; travel, march; go about, gad; parade, strut;
ament	fit with a throwing strap; give impetus with a throwing strap; speed on;
amerci	fine, penalize;
amic	propitiate, make friendly to oneself;
amigr	go away, remove;
ammatur	hasten (an occurrence); bring to maturity, mature, ripen;
amment	fit with a throwing strap; give impetus with a throwing strap; speed on;
amme	go to, approach;
ammigr	go and live with; go to a place; come to; be added to;
amministr	administer, manage, direct; assist; operate, conduct; maneuver (ship); bestow;
ammulc	stroke;
ammutil	cut/clip close; shave; fleece, cheat, defraud;
am	love, like; fall in love with; be fond of; have a tendency to;
amoen	make pleasant (places); please, delight;
amplific	enlarge, extend, increase; develop; magnify, amplify; praise loudly, exalt;
ampli	enlarge, augment, intensify, widen; ennoble, glorify; postpone, adjourn;
ampl	enlarge, extend, increase; develop; magnify, amplify; praise, exalt, glorify;
amptru	execute a figure/movement (by leader of ceremonial dance);
amput	lop/cut off, prune, shorten; amputate; eradicate, exclude, take away; castrate;
amtru	dance around (at Salian religious festivals);
amussit	make according to ruler/accurately/exactly/nicely;
amyl	mix with starch;
analyz	analyze;
anathematiz	anathemize, put under ban; curse; detest;
anathem	anathematize, anathemize, put under ban; curse; detest;
ancl	serve (wine); bring as a servant; have the care of (L+S);
ancul	serve (wine); bring as a servant; have the care of (L+S);
andru	run back; (dance around at Salian religious festivals);
angari	press, requisition, commandeer; exact villeinage; compel, constrain (eccl.);
angori	compel; force;
angul	make angular/cornered;
angust	narrow, reduce width/size/amount, constrict, limit; choke, crowd together/hamper
anhel	pant, gasp; breathe/gasp out, belch forth, exhale; utter breathlessly;
anim	animate, give/bring life; revive, refresh; rouse, animate; inspire; blow;
annat	swim to/up to; swim beside/alongside;
annavig	sail to/up to/towards; sail beside/alongside;
anneg	refuse; withhold;
annict	wink to/at; blink at;
annihil	annihilate, destroy, demolish, ruin, bring to nothing;
ann	swim to/towards, approach by swimming; sail to/towards; brought by sea (goods);
ann	pass/live through a year;
annod	cut (shoot) right back, cut flush; cut off knots, cut away suckers;
annot	note/jot down, notice, become aware; mark, annotate; record, state; designate;
annubil	bring up clouds (against);
annull	annihilate, obliterate, destroy; annul (eccl.);
annumer	count (in/out), pay; reckon (time); enumerate, run through; classify as; add;
annunti	announce, say, make known; report, bring news; prophesy/announce before; preach;
annut	nod (to); order/assent to by a nod; bow to;
antevi	go before, precede;
antevol	fly in front of/before;
anticip	occupy beforehand; anticipate, get the lead, get ahead of; have preconception;
antiqu	reject (bill); vote for the rejection;
antist	stand before; surpass, excel, be superior to;
antist	surpass, excel, be superior to; stand before;
anto	requite;
antru	dance around (at Salian religious festivals);
apert	bare, expose, lay bare;
apocul	go away, remove oneself, leave;
apolactiz	kick away, spurn;
apolog	spurn, reject;
apostat	fall away (from), apostatize, forsake one's religion;
apothec	store, lay up in a storehouse;
apozym	make ferment;
appar	prepare, fit out, make ready, equip, provide; attempt; organize (project);
appector	press/clasp to the breast;
appellit	call or name (frequently or habitually);
appell	call (upon); address; dun; solicit; appeal (to); bring to court; accuse; name;
applic	apply, put in practice;
applic	connect, place near, bring into contact; land (ship); adapt; apply/devote to;
applic	connect, place near, bring into contact; land (ship); adapt; apply/devote to;
applor	lament, weep at/on account of; deplore (thing);
applumb	solder, solder on, affix by soldering, close/seal by soldering/with solder;
apport	carry/convey/bring (to); import; present (play); bring (news); make one's way;
appostul	beg/entreaty/solicit importunately/persistently/troublesomely/pressingly;
appreci	value/prize, set/estimate price, appraise; purchase/buy; appropriate to self;
apprens	snatch at;
appreti	value/prize, set/estimate price, appraise; purchase/buy; appropriate to self;
approb	approve, commend, endorse; prove; confirm; justify; allow; make good;
appron	lean forwards;
approper	hasten, hurry, come hastily, make haste; accelerate, speed up;
appropinqu	approach (w/DAT or ad+ACC); come near to, draw near/nigh (space/time); be close;
appropi	approach (w/DAT or ad+ACC); come near to, draw near/nigh (space/time); be close;
appropri	appropriate, make one's own;
approxim	be/draw/come close/near to, approach;
appugn	attack, assault;
apsent	send away, cause one to be absent; be absent;
apson	have harsh/discordant/unpleasant sound;
apst	stand at a distance, stand off; keep at a distance;
apt	adapt, fit, apply, adjust, accommodate; put on, fasten; prepare, furnish;
aratr	plow in (young grain to improve the yield), plow (after sowing);
arbust	plant (with trees), forest, reforest;
arct	wedge in, fit/close firmly; tighten/compress/abridge/contract; pack/limit/cramp;
arcu	bend into the shape of a bow/arch;
ariet	butt like a ram, batter/buffet, harass; strike violently; collide; stumble/trip;
ariol	divine; foretell, prophesy; use divination;
arm	equip, fit with armor; arm; strengthen; rouse, stir; incite war; rig (ship);
ar	plow, till, cultivate; produce by plowing, grow; furrow, wrinkle;
aromatiz	smell of spice; make aromatic/fragrant/sweet smelling (Ecc);
arrami	arraign; indict, accuse;
arremig	row up to/towards;
arrest	arrest; seize;
arrig	water (plants), moisten the soil around;
arrog	ask, question; arrogate to one's self, claim, make undue claim; confer (upon);
arrog	|adopt (an adult) as one's son (esp. at his instance);
arror	moisten, bedew;
articul	divide into distinct parts, articulate;
art	wedge in, fit/close firmly, tighten; compress, abridge; pack, limit, cramp;
artr	plow (in young grain to improve the yield), plow (after sowing);
artr	plow in young grain to improve the yield;
asci	chop/slice with a trowel;
aspect	look/gaze at/upon; observe, watch; pay heed; face/look towards (place/person);
asper	roughen; sharpen, point, tip; enrage, make fierce/violent; grate on; aggravate;
aspir	breathe/blow (upon); aspirate; instill, infuse; be fragrant; influence; aspire;
asport	carry/take away, remove;
asserv	keep/guard/preserve; watch/observe; keep in custody; rescue/save life; reserve;
assever	act earnestly; assert strongly/emphatically, declare; profess; be serious;
assibil	hiss out (breath) upon (w/DAT); murmur/whisper to/at (L+S);
assicc	dry, dry out, dry up, make dry;
assidu	apply constantly; make constant use of (Souter); use regularly/incessantly;
assignific	show (w/ACC + INF), make evident; mean/denote (words);
assign	assign, distribute, allot; award, bestow (rank/honors); impute; affix seal;
assimul	make like; compare; counterfeit, simulate, imitate, pretend, feign, act a part;
ass	roast, bake, broil; dry;
associ	join/attach (to), associate/work (with); unite with; attend upon; escort (Ecc);
assol	level to the ground, destroy;
asson	respond, reply; sound in accompaniment; sing as an accompaniment;
assult	jump/leap at/towards/upon; dash against; attack, assault, make an attack (on);
assuspir	sigh in response (to) (w/DAT);
ast	stand at/on/by; assist; stand up/upright/waiting/still, stand on one's feet;
astrangul	strangle;
astrific	make/produce stars;
ategr	pour out wine in sacrifices;
atopt	adopt, select, secure, pick out; wish/name for oneself; adopt legally;
attamin	touch, attack, rob; dishonor, defile, contaminate;
attegr	pour out wine in sacrifices;
attemper	fit, adjust, accommodate;
attempt	attack, assail; call into question; try to seduce/use; make an attempt on, try;
attent	attack, assail; call into question; try to seduce/use; make an attempt on, try;
attenu	thin (out); weaken, lessen, diminish, shrink, reduce in size; make plain;
attermin	set bounds to, measure, limit;
atticiss	imitate the Attic/Athenian (elegant) manner of speaking;
attill	tickle, please;
attitul	name, entitle;
attoler	support, sustain, bear;
atton	strike with lightning, blast; drive crazy, distract;
attorn	attorn; attribute; ordain, decree; turn to;
attract	touch; lay hands on; handle (roughly), assault (sexually), violate; deal with;
attrect	touch; lay hands on; handle (roughly), assault (sexually), violate; deal with;
attrepid	bestir oneself; hobble along;
attribul	thresh, press hard;
attumul	heap up against; bank up (with something);
auctific	enlarge, increase; honor by offerings/sacrifices;
auctit	keep increasing/augmenting; honor by offerings (L+S);
auct	increase/enlarge (much), grow; prosper/bless (with) (w/ABL);
auctoriz	authorize, authenticate; approve, confirm; bind one's self;
auctumn	bring autumnal conditions;
audit	hear frequently;
augific	increase, enlarge, make larger;
augment	increase;
august	glorify; render venerable;
aur	gild, overlay with gold;
auror	shine like the sunrise;
aurugin	have jaundice, be affected with jaundice;
auscult	listen (to); overhear, listen secretly; heed, obey;
authentic	verify, authenticate;
authoriz	authorize, authenticate; approve, confirm; bind one's self;
automatiz	automate;
autumn	bring autumnal conditions;
autum	say, assert; say yes; affirm; mention, speak of; name, call; reckon, judge;
averrunc	avert (something bad), ward off;
avoc	call/summon away; dissuade, divert, distract; remove, take away (property);
avol	fly/rush away/off; hasten away, flee, vanish; fly away (missile);
badiss	go, proceed; walk;
badiz	go, proceed; walk;
baijul	carry, bear (load);
bajul	carry, bear (load);
balit	bleat;
ball	dance;
bal	bleat, baa (like a sheep); talk foolishly;
baptiz	baptize; immerse;
barb	supply with a beard (or perhaps a nonsense word);
basi	kiss, give a kiss;
beatific	bless; make happy;
beb	bleat;
bel	bleat, baa (like a sheep); talk foolishly;
be	bless, make happy, gladden, delight; enrich (with);
betiss	be languid (soft as a beet);
betiz	be languid (soft as a beet);
bin	duplicate; binate (offer two masses in one day);
bitumin	cover/impregnate with bitumen/tar; tar;
blacter	bleat (of a ram/sheep);
blasphem	blaspheme (against God); revile; reproach;
blater	prate, babble; utter in a babbling way; (applied to sounds of certain animals);
blatter	prate, babble; utter in a babbling way; (applied to sounds of certain animals);
blatt	prate, babble; utter in a babbling way; (applied to sounds of certain animals);
boicotiz	boycott;
bombard	bombard;
bombil	buzz, hum;
bombit	buzz, hum;
bo	cry aloud, roar, bellow; call loudly upon;
boton	button;
bov	cry aloud, roar, bellow; call loudly upon;
braci	brew beer;
brevi	shorten, abridge; abbreviate (speech/writing); pronounce short;
bubin	menstruate, have monthly period (woman);
bubul	screech (like an owl);
buccin	give signal with/sound trumpet/horn; blow trumpet (bucina); honk horn (Cal);
bucin	give signal with/sound trumpet/horn; blow trumpet (bucina); honk (Cal);
bulim	have great/insatiable hunger;
bull	bubble, boil, effervesce;
buvin	menstruate, have monthly period (woman);
cacab	cackle; natural cry of partridge;
cachinn	laugh aloud or boisterously, guffaw; laugh loudly at;
cac	defecate; defecate upon; defile with excrement; (rude);
cacumin	make pointed or tapered; sharpen;
caec	blind; obscure, confuse, hide; morally blind; [stu ~ => throw dust, deceive];
caecult	be dim-sighted, see badly, be almost blind; be like one blind/unseeing;
cael	carve, make raised work/relief; engrave, emboss; chase, finish; embroider;
caement	cement, fasten with mortar;
caenit	dine/eat habitually (in a particular place/manner); have dinner, dine (often);
caen	dine, eat dinner/supper; have dinner with; dine on, make a meal of;
caespit	stumble;
cai	beat, thrash, cudgel;
calce	put shoes on, furnish with shoes; shoe (horses); put feet in something;
calci	put shoes on, furnish with shoes, shoe (horses); put feet in something;
calcitr	kick with heels, kick; be refractory; resist; kick convulsively (dying);
calc	tread/trample upon/under foot, crush; tamp/ram down; spurn; copulate (cock);
calcul	calculate, compute, reckon; consider as; esteem;
calec	coat with lime/whitewash, whitewash;
calefact	heat, warm; make a person warm by beating;
calic	coat with lime/whitewash, whitewash;
calig	be dark/gloomy/misty/cloudy; have bad vision; cloud; be blinded; be/make dizzy;
callig	be dark/gloomy/misty/cloudy; have bad vision; cloud; be blinded; be/make dizzy;
cal	announce, proclaim; summon, convoke, call forth/together;
cal	|let down, allow to hang free; loosen; slacken;
calv	make/leave bare;
camar	roof/vault over;
cambi	exchange, barter;
cambi	change (of money);
camer	roof/vault over;
camin	form into an oven; shape like an oven;
camps	go around; double; turn around in place;
cancell	arrange in criss-cross pattern; enclose in lattice/grid; cancel, cross out;
candic	have white appearance; be white/whitish;
candid	make glittering/bright; make white;
canoniz	canonize, elevate to sainthood; include in canon of Scripture; reduce to rules;
cantill	sing low; hum; warble, chirp (Ecc);
cantil	sing;
cantit	sing; sing repeatedly, sing over and over; sing/play often (L+S);
cant	sing; play (roles/music); recite; praise, celebrate; forewarn; enchant, bewitch;
caperr	be/become wrinkled; wrinkle (L+S); furl (sails);
capistr	provide with a halter, put a halter on a horse; fasten with a headstall; bind;
caprific	caprificate, fertilize by caprification (insects/hand puncturing wild fig);
captit	snatch at; strive eagerly after;
captiv	take captive;
capt	try/long/aim for, desire; entice; hunt legacy; try to catch/grasp/seize/reach;
capul	draw off oil from oil press; attach/halter (cattle); catch (animals);
carmin	card (wool, etc.); produce by carding;
carmin	|make verses;
carric	charge (a weapon, a battery);
casit	fall/drop down repeatedly/frequently;
cassit	drip;
cass	totter, begin to fall; shake, waver (L+S);
cass	bring to naught, destroy; annul, make null and void;
castific	punish, correct; make pure;
castig	chastise/chasten, punish; correct, reprimand/dress down, castigate; neutralize;
castr	castrate, emasculate/unman; spay (animal); dock (tail); diminish/impair/weaken;
cataplasm	apply a poultice/plaster (to);
catechiss	instruct in religion, teach by question and answer, catechize;
catechiz	instruct in religion, teach by question and answer, catechize;
cateciz	instruct in religion, teach by question and answer, catechize;
caten	chain/bind/tie/shackle together; secure with bonds/chains/fetters;
catill	lick plates;
catomidi	lay one over shoulders of another and flog him; strike on shoulders;
cauteri	burn/mark with a branding iron, brand;
cauteriz	cauterize, burn with a hot iron; mark with a branding iron, brand;
cavern	make hollow;
cav	hollow out, make concave/hollow; excavate; cut/pierce through; carve in relief;
celebr	celebrate/perform; frequent; honor/glorify; publicize/advertise; discuss/bandy;
celer	quicken/accelerate; make haste, act quickly/be quick; hasten, hurry, do quickly;
cel	conceal, hide, keep secret; disguise; keep in dark/in ignorance; shield;
cenit	dine/eat habitually (in a particular place/manner); have dinner, dine (often);
cen	dine, eat dinner/supper; have dinner with; dine on, make a meal of;
centensim	take out every hundredth (for punishment), centesimate;
centraliz	centralize;
centuplic	increase a hundredfold;
centuri	arrange/assign (soldiers) in military centuries; divide land into centuriae;
cerific	make wax; spawn (of purple-fish) (make wax/prepare slimy nest for eggs);
cernul	throw headlong; throw down (L+S);
cernu	fall headfirst; dive; turn a somersault;
cer	smear/coat with wax;
certific	certify; register
certior	inform, show, apprise;
cespit	stumble;
cess	be remiss/inactive; hold back, leave off, delay, cease from; rest; be free of;
chal	let down, allow to hang free; loosen;
charaz	scratch, engrave;
charmid	Charmidize, turn into Charmides (comic character in Plautus' play Trinummus);
chenturi	arrange/assign (soldiers) in military centuries; divide land into centuriae;
Christianiz	profess Christianity;
cib	feed, give food/fodder to animals/men; (also passive sense) eat, take food;
cicur	tame; pacify;
cinematograph	film;
circin	bend/make circular/round; traverse circular course, wheel through; take round;
circit	go round as a hawker/peddler/solicitor; frequent, be busy (L+S);
circ	traverse; go about (L+S); wander through;
circumaedific	build round about; (Vulgate Lamentations 3:7);
circumagger	pile (earth) round about; surround (with heaped earth);
circumambul	walk around/over;
circumar	plow around, surround with a furrow;
circumcalc	tread/trample earth (down around);
circumcirc	encircle, surround; border; skirt; circulate/wander through; go/measure round;
circumclam	roar around (waves/surf);
circumctip	surround, accompany, attend;
circumculc	tread/trample earth (down around);
circumcumul	heap/pile up around;
circumcurs	run about; run round (of person); run about (of things), revolve;
circumd	surround; envelop, post/put/place/build around; enclose; beset; pass around;
circumdol	chop around with an ax; hew off around (L+S);
circumequit	ride around;
circumerr	wander/prowl/meander/stroll/hover around; orbit, go around in orbit (planet);
circumfirm	fasten round;
circumflagr	blaze/scorch all around;
circumfl	blow around; blow on/assail from all sides; veer around (wind);
circumfor	pierce with holes round about;
circumfric	rub/brush round about; scour;
circumfric	rub/brush round about; scour;
circumgel	freeze/harden round/all around;
circumgest	carry/bear about/around;
circumglob	form a ball/cluster/sphere (around something);
circumlaque	wind around; (like a noose);
circumlatr	bark round about; roar around (L+S);
circumlav	wash round about/around, wash side of; flow all around (waters) (L+S);
circumlev	raise up all around;
circumlig	bind around/to; encircle, surround; attach, fasten; pass/wrap around, bandage;
circumlustr	traverse (in circular course), pace around; go around (in purifying ceremony);
circumme	go/travel/pass around;
circumnavig	sail around; circumnavigate;
circumn	swim around;
circumnot	draw/paint around;
circumplic	coil round (like a snake); wind (strip) around; twine/bend around;
circumplumb	coat (all over) with lead; pour lead all around (L+S);
circumpuls	assail/beat/pulsate from every side; (with noise, etc);
circumpurg	clear/clean/purify/free from adhesions all around/round about;
circumput	measure around;
circumror	sprinkle (water) over/round;
circumrot	cause to revolve/rotate; turn/whirl around; turn around in a circle;
circumsalt	dance around (chorus); jump around;
circumscariphic	scrape/scratch around/about; scarify around (L+S);
circumscariph	scrape/scratch around/about; scarify around (L+S);
circumsec	cut/clip/pare round; circumcise;
circumsepar	separate around;
circumsign	mark/sign/seal round about;
circumson	resound on every side; echo round; surround/be filled (with noise/sound);
circumspect	look about (searchingly), search about; examine, watch (suspiciously), be alert;
circumstagn	be poured forth all around;
circumst	stand/gather/crowd around, surround, beset; be on either side;
circumsud	sweat/be moist all around/on all sides;
circumtermin	bound/limit round about/all around;
circumton	make a loud noise/clamor round; thunder round;
circumvall	surround with wall/siegeworks; blockade; beset, surround with troops/barriers;
circumvel	cover around, envelop;
circumvolit	fly around/round about/over; (of horsemen/horses' hooves); frequent; flit;
circumvol	fly/hover/flutter around; run/hasten/rush around;
circund	surround; envelop, post/put/place/build around; enclose; beset; pass around;
cithariz	play on/strike cithara/lyre;
cit	urge on, encourage; promote, excite; summon; set in motion; move (bowels); cite;
civiliz	civilize;
clamit	cry out, yell; shout repeatedly, clamor; proclaim; name/call repeatedly/loudly;
clam	proclaim, declare; cry/shout out; shout/call name of; accompany with shouts;
claricit	recall, recollect, remember;
claric	shine, gleam, glow;
clarific	make illustrious/famous;
clarigit	recall, recollect, remember;
clarig	demand satisfaction formally (from another state in formal declaration of war);
clar	make visible; brighten, light up; make clear, explain; make illustrious/famous;
clatr	fit with bars or railings;
claudic	limp, be lame; waver, incline to one side; be defective/deficient/fall short;
clav	nail, furnish/fasten with nails; furnish with points/prickles or purple stripe;
clin	incline, slope; bend; sink;
clipe	provide/arm with a shield (clipeus) or protection;
cloac	daub; stain, pollute; soil; smear;
clodic	limp, be lame; be defective; (facetious plebeian of claudico);
cloniz	clone;
clue	purify; cleanse, make clean;
clupe	provide/arm with a shield (clipeus) or protection;
clype	provide/arm with a shield (clipeus) or protection;
clysteriz	apply a syringe/clyster; give an injection/enema; purge;
coacerv	heap/pile up, gather/crowd together; amass, collect; make by heaping; add/total;
coact	compel; constrain; force;
coadjut	urge; help, assist;
coador	worship/adore together/along with;
coadun	unite; add/join together; collect into one;
coaedific	build (town/etc); occupy (site) with buildings; build up/upon;
coaegrot	be sick at same time as;
coaequ	make level/equal, equalize; regard/treat as equal, equate; adjust by weighing;
coaestim	estimate together/in conjunction (with);
coaetane	be of same age/contemporary;
coagger	heap/cover over (with); heap together (L+S);
coagit	shake together;
coagment	join/fasten together, connect; make by joining/construct; fit (words) together;
coagul	curdle (milk); make (liquids) thick/solid, congeal, coagulate; collect together;
coambul	walk/go/travel with/together;
coangust	confine to narrow space, cramp; make narrower; narrow/limit scope/application;
coapt	fit/join/adjust together; make by joining;
coarct	narrow; hem in, pack/crowd/bring/fit close together, restrict; shorten/abridge;
coarm	arm/equip together;
coarticul	cause to speak/articulate;
coart	narrow; hem in, pack/crowd/bring/fit close together, restrict; shorten/abridge;
coass	fit with floor planking; join boards/planks together (L+S);
coaudit	confine to narrow space, cramp; make narrower; narrow scope/application;
coax	croak; (of frogs);
coax	fit with floor planking; join boards/planks together (L+S);
cocin	cook, prepare food;
cocit	cook; boil, fry, bake; burn, parch (sun); stir up; ripen, mature (plot); digest;
coenit	dine/eat habitually (in a particular place/manner); have dinner, dine (often);
coen	dine, eat dinner/supper; have dinner with; dine on, make a meal of;
coept	begin/commence (w/INF); set to work, undertake/attempt/try; venture/begin (ACC);
coerr	go/wander around together;
cogit	think; consider, reflect on, ponder; imagine, picture; intend, look forward to;
cogul	curdle (milk); make (liquids) thick/solid, congeal, coagulate; collect together;
cohabit	dwell/live together;
cohonest	honor, grace; do honor/pay respect to; make respectable; prevent baldness (L+S);
cohumid	wet all over; moisten;
coinquin	befoul/pollute/defile wholly (immorality); contaminate/taint/infect (w/disease);
coject	conjecture, think, imagine, infer, guess, conclude; judge, draw a conclusion;
coject	|throw together; assemble; throw (person in prison); interpret (portent);
colaphiz	box one's ears; cuff;
colig	bind/tie/pack together/up, connect, unite, unify; fetter, bind, put in bonds;
collabefact	cause to topple over; make to reel/totter (L+S); overpower/subdue; melt (metal);
collabell	make/form by putting lips together;
collabor	labor/work with/together;
collacer	lacerate severely; tear to pieces (L+S);
collacrim	weep together, weep in company of someone; weep over/for (w/ACC); bewail;
collacrum	weep together, weep in company of someone; weep over/for (w/ACC); bewail;
collater	admit on both sides;
collatr	bark in chorus at; bark/yelp fiercely at (L+S); inveigh against;
collaud	praise/extol highly; commend; eulogize;
collax	loosen; make loose/porous (L+S);
collev	make (entirely) smooth; smooth;
collibr	measure; measure off (L+S);
collig	bind/tie/pack together/up, connect, unite/unify; fetter/bind; immobilize, stop;
collim	direct (eyes) sideways; glance sidelong;
colline	align, direct, aim; direct in a straight line (L+S);
collini	align, direct, aim; direct in a straight line (L+S);
colloc	place/put/set in order/proper position, arrange; station, post, position; apply;
colloc	|put together, assemble; settle/establish in a place/marriage; billet; lie down;
collocuplet	enrich, make wealthy/very rich; embellish, adorn;
colluc	prune; thin out (trees); clear/thin (forest) (L+S);
collumin	illuminate;
collustr	illuminate, make bright, light up fully; look over, survey; traverse, explore;
collutit	soil/defile greatly/thoroughly;
collutlent	cover over with mud;
col	strain/filter (liquid), clarify; purify; remove solids by filter; wash (gold);
color	color; paint; dye; tan; make darker; give deceptive color/gloss/appearance to;
combin	unite, combine;
comiti	offer sacrifice after which comitia could be held; go to comitia (L+S);
commacer	macerate, soften by steeping in liquid;
commacul	stain deeply, pollute, defile; contaminate, defile morally; sully (reputation);
commalax	soften/subdue completely; make entirely mild (L+S);
commalle	weld on, attach;
commalliol	weld on, attach;
commanifest	manifest together;
commargin	furnish with a parapet or railing;
commascul	screw up (one's courage); make manly/firm/courageous (L+S); invigorate/embolden;
commastic	chew;
commelet	exercise, practice assiduously;
commemor	recall (to self/other); keep in mind, remember; mention/relate; place on record;
commend	entrust, give in trust; commit; recommend, commend to; point out, designate;
commensur	measure/make equal; correspond;
comme	go to, visit, travel; pass; resort to; go to and fro, come and go; communicate;
commet	go constantly/frequently; come and go; survey thoroughly (facetious);
commigr	migrate, go and live (elsewhere); move one's home with all effects; enter;
commilit	fight on same side/in company; be a comrade/companion in arms/battle/war;
commitig	soften; make soft (L+S); mellow;
commod	lend, hire; give, bestow, provide; put at disposal of, oblige; make fit, adapt;
commonstr	point out (fully/distinctly), show where; make known, declare, reveal;
commorsic	bite all over; devour (with eyes); bite to pieces (L+S);
commorsit	bite all over; devour (with eyes); bite to pieces (L+S);
commostr	point out (fully/distinctly), show where; make known, declare, reveal;
commot	move very violently; agitate;
commulc	beat violently/thoroughly;
commund	clean/cleanse thoroughly; purify wholly (L+S);
commut	change; alter wholly, rearrange, replace; transform; exchange, barter, sell;
com	be furnished/covered with hair; clothe/deck with hair/something hair-like;
compac	bring to peace;
compagin	join together; border upon; (fields);
compalp	stroke, caress;
compar	prepare; provide; compose; collect, get together/hold of; raise (force); unite;
compar	|place together, match, couple, pair; set/pit against; treat as equal; compare;
compar	||set up/establish/institute; arrange, dispose, settle; buy, acquire, secure;
compecc	err/sin/commit a fault together;
compell	address/accost, speak to, call upon; appeal to; challenge; chide/rebuke; accuse;
compendi	shorten, abridge (sermon); shorten/cut short (life), kill;
compens	balance/weigh/offset; get rid of; make good, compensate; save/secure; short cut;
comperendin	adjourn trial of a person; adjourn trial; (for two days or later);
compil	rob/pillage, snatch; steal from (another author)/plagiarize; beat up thoroughly;
complac	conciliate (greatly), placate; win sympathy of;
complan	make (ground) level/flat; smooth out (trouble); pull down, raze to ground;
complant	plant together;
complic	fold/tie up/together; roll/curl/double up, wind (round); involve; bend at joint;
complic	fold/tie up/together; roll/curl/double up, wind (round); involve; bend at joint;
complor	bewail, bemoan; lament loudly/together/violently; despair of; morn for;
comport	carry, transport, bring in, convey (to market); bring together; amass, collect;
compot	drink together;
comprehens	seize in an embrace; embrace, hug;
compress	press; oppress;
comprob	approve, accept, sanction, ratify; prove, justify, confirm, attest, bear out;
compugn	fight together/with; struggle together (in argument);
compuls	batter, pound;
compurg	purify completely/thoroughly;
comput	reckon/compute/calculate, sum/count (up); take/include in reckoning; work out;
conangust	confine to narrow space, cramp; make narrower; narrow scope/application;
conaudit	confine to narrow space, cramp; make narrower; narrow scope/application;
concac	soil, pollute, defile, make foul (with excrement/ordure/dung);
concal	summon;
concamar	cover with an arch/vault, vault over;
concamer	cover with an arch/vault, vault over;
concarn	incarnate, unite/clothe with flesh;
concastig	chastise severely/thoroughly, punish; censure, dress down;
concaten	link/bind together; connect;
concav	hollow out; round, curve; give hollow/curved form; hollows (pl.), a glen (Ecc);
concelebr	celebrate, make known; go often/in large numbers/together, frequent, haunt;
concel	keep secret, conceal altogether; conceal carefully (L+S);
concenturi	assemble by centuries, gather by hundreds; marshal, bring together, prepare;
concept	conceive, become pregnant; conceive in mind;
concer	connect, join, twine; join in conflict;
concess	cease/desist temporarily, leave off; rest;
concili	unite, bring together/about; cause; win over, attract; acquire, procure, buy;
concili	|attract favor of, render favorably disposed; commend, endear; acquire; gain;
concili	||bring a woman to man as wife, match; procure as a mistress; obtain improperly;
concinn	prepare/make ready; repair, put/set right/in order, touch up; arrange suitably;
concinn	|make up, construct, concoct, put together; bring about, cause; render, make;
concipil	seize, take, catch; lay violent hands on;
concit	stir up, disturb; discharge/hurl (missile); flow rapidly/strong current; rush;
concit	|rush; urge/rouse/agitate; enrage/inflame; spur/impel; summon/assemble; cause;
conclamit	keep shouting loudly; cry; call/cry out loudly (L+S);
conclam	cry/shout aloud/out; make resound w/shouts; give a signal; summon; bewail/mourn;
conclav	nail together;
concopul	join, unite;
concord	harmonize; be in harmony/agreement/on good terms/friendly; agree; go by pattern;
concorpor	unite into a single body, make one; incorporate (L+S);
concrass	thicken, make thick;
concrem	consume by fire; burn up/down entirely/completely/thoroughly; burn together;
concre	create together;
concrepati	rattle/sound much/thoroughly/loudly;
concrep	make noise (door), grate/creak; sound, crash/clash, rattle; snap (fingers);
concrisp	curl (hair); move in curls, curl/swirl (vapors/fog); brandish (weapon) (L+S);
concrucifig	crucify together;
concrusi	cause violent pain; torment, rack, torture severely;
concub	lie with (sexual and not); have sexual intercourse with;
conculc	tread/trample upon/underfoot/down; crush, oppress; despise, disregard;
concur	attend to thoroughly/completely; care for suitably (L+S);
concurs	rush/run to and fro/about/together/to visit; clash; visit in turn; run through;
concurv	bend down; bend, curve (L+S);
condecor	adorn, embellish with ornament/excessively/carefully; decorate, grace;
condelect	delight in; (PASSIVE) be delighted with something;
condemn	condemn, doom, convict; find guilty; (pass) sentence; blame, censure, impugn;
condens	compress; pack/press closely together; condense/make firm; (PASS) grow thickly;
condom	check, curb; tame completely;
condon	give (away/up); present; make present of; forgive/pardon/absolve; sacrifice to;
condulc	sweeten;
condumn	condemn, doom, convict; find guilty; (pass) sentence; blame, censure, impugn;
conduplic	double, make twofold/twice as much/great; make two kinds; embrace (w/corpora);
condur	harden, make hard;
conest	honor, grace; do honor/pay respect to; make respectable; prevent baldness (L+S);
confarre	marry by confarreatio (ceremony with meal/grain offering); contract marriage;
confeder	confederate; join in league;
conferment	leaven, ferment through and through;
conferrumin	cause to join; knit together (fractures); cement (L+S); solder together;
conferumin	cause to join; knit together (fractures); cement (L+S); solder together;
confict	fabricate/invent/concoct an accusation/falsehood together; counterfeit/feign;
configur	mold, shape; form from/after something, fashion accordingly (L+S);
confirm	strengthen, develop, build up (w/troops); make secure/firm; reassure; secure;
confirm	|assert positively; declare, prove, confirm, support; sanction; encourage;
confisc	confiscate/seize (for the public treasury); lay-up in a treasury, store;
conflabell	fan violently; kindle;
conflagr	be on fire/burn; be burnt down/consumed/utterly destroyed; be/become inflamed;
conflamm	inflame;
confl	kindle/ignite, blow on; arouse/stir up; melt (down); cast/weld; run up debt;
confl	|start, cause, bring about; bring/rake together, compose; invent/concoct (lie);
confl	||forge; refine, purify; inflame;
confluctu	wave, swell, undulate, fluctuate; surge/rise in waves on all sides (L+S);
confoeder	unite, join in a league;
confoed	befoul, make filthy;
conform	shape/mold skillfully; outline, describe; train/educate/teach; make to agree;
confornic	vault over, over-arch, cover with an arched roof;
confrequent	visit frequently/in large numbers, frequent; increase in numbers;
confrequent	|celebrate/keep (festival); keep in mind; maintain (memory of the dead);
confric	rub vigorously; rub (with unguents, massage, rub down (body); rub/make smooth;
confri	cover with power (or the like); rub in (L+S);
confrix	roast/fry (with something);
confront	confront;
confuner	bury, inter; ruin, destroy;
confut	restrain, check, repress, dampen, suppress, diminish; keep from boiling over;
confut	|abash, silence (accuser); shock; disprove, refute; convict of error; put down;
confutu	have sexual intercourse with (woman); (rude); lie with conjugally (L+S);
congel	cause to freeze/congeal/grow hard; (PASS) become frozen, congeal/curdle/freeze;
congel	|harden; make/become hard; strike fear into, chill; render/become inactive;
congemin	double; increase; combine to double size; redouble; employ in repeated action;
congener	bind by ties of kinship, unite; give birth/beget/produce at the same time;
congenicl	fall on one's knees;
congenucl	fall on one's knees;
congermin	sprout, put forth shoots; shoot forth at the same time (L+S);
congest	bring/carry together;
conglob	form/make into a ball; roll up; accumulate; crowd/press/mass together; clot;
conglomer	concentrate, gather into a compact mass; heap (evils upon a person) (w/in+ACC);
conglorific	glorify together with (others); (PASSIVE) be glorified with;
congraec	squander like a Greek; lavish on banquets, squander on luxury (L+S);
congreg	collect/bring together/assemble/convene; flock, congregate; group; concentrate;
congyr	circle, make a circle around a person;
coninquin	befoul/pollute/defile wholly (immorality); contaminate/taint/infect (w/disease);
conisc	brandish/shake/quiver; flash/glitter, emit/reflect intermittent/quivering light;
conject	conjecture, think, imagine, infer, guess, conclude; judge, draw a conclusion;
conject	|throw together; assemble; throw (person in prison); interpret (portent);
conjug	join in marriage; form a friendship; join together, unite in (L+S);
conjur	swear/act together, join in an oath/plot; conspire, plot; form alliance/league;
conlabefact	cause to topple over; make to reel/totter (L+S); overpower/subdue; melt (metal);
conlabell	make/form by putting the lips together;
conlab	labor/work with/together;
conlacer	lacerate severely; tear to pieces (L+S);
conlacrim	weep together, weep in the company of someone; weep over/for (w/ACC); bewail;
conlacrum	weep together, weep in the company of someone; weep over/for (w/ACC); bewail;
conlater	admit on both sides;
conlatr	bark in chorus at; bark/yelp fiercely at (L+S); inveigh against;
conlaud	praise/extol highly; commend; eulogize;
conlax	loosen; make loose/porous (L+S);
conlev	make (entirely) smooth; smooth;
conlibr	measure; measure off (L+S);
conlig	bind/tie/pack together/up, connect, unite/unify; fetter/bind; immobilize, stop;
conlim	direct (the eyes) sideways; glance sidelong;
conline	align, direct, aim;
conlini	align, direct, aim;
conloc	place/put/set in order/proper position, arrange; station, post, position; apply;
conloc	|put together, assemble; settle/establish in a place/marriage; billet; lie down;
conlocuplet	enrich, make wealthy/very rich; embellish, adorn;
conluc	prune; thin out (trees); clear/thin (forest) (L+S);
conlumin	illuminate (on all sides/fully);
conlustr	illuminate, make bright, light up fully; look over, survey; traverse, explore;
conlutit	soil/defile greatly/thoroughly;
conlutlent	cover over with mud;
conmemor	recall (to self/other); keep in mind, remember; mention/relate; place on record;
conmitig	soften; make soft (L+S); mellow;
conmonstr	point out (fully/distinctly), show where; make known, declare, reveal;
conmostr	point out (fully/distinctly), show where; make known, declare, reveal;
connumer	reckon in, include in counting/the count; number with, reckon among (L+S);
conpar	prepare; provide; compose; collect, get together/hold of; raise (force); unite;
conpar	|place together, match, couple, pair; set/pit against; treat as equal; compare;
conpar	||set up/establish/institute; arrange, dispose, settle; buy, acquire, secure;
conpell	address, accost, speak to, call upon; appeal to; challenge; chide/rebuke; accuse
conpens	balance/weigh, offset; get rid of; make good, compensate; save/secure; short cut
conperendin	adjourn the trial of a person; adjourn a trial; (for two days or later);
conpil	rob, pillage, steal from (another writer), plagiarize; beat up thoroughly;
conplac	conciliate (greatly), placate; win the sympathy of;
conplan	make (ground) level/flat; smooth out (trouble); pull down, raze to the ground;
conplic	fold/tie up/together; roll/curl/double up, wind (round); involve; bend at joint;
conplic	fold/tie up/together; roll/curl/double up, wind (round); involve; bend at joint;
conplor	bewail, bemoan; lament loudly/together/violently; despair of; morn for;
conport	carry, transport, bring in, convey (to market); bring together; amass, collect;
conpot	drink together;
conprehens	seize in an embrace; embrace, hug;
conprob	approve, accept, sanction, ratify; prove, justify, confirm, attest, bear out;
conpuls	batter, pound;
conpurg	purify completely/thoroughly;
conput	reckon/compute/calculate, sum/count (up); take/include in reckoning; work out;
conquadr	agree with, be proportioned to; square to;
conquadr	make square, square;
conquass	shake violently; break, shatter; unsettle, disturb, throw into confusion;
conquin	befoul/pollute/defile wholly (immorality); contaminate/taint/infect (w/disease);
conregn	reign together with one;
conrept	creep;
conresuscit	raise up/from the dead together;
conriv	lead/channel (water) into the same channel/basin, collect;
conrobor	strengthen, harden, reinforce; corroborate; mature; make powerful, fortify;
conrog	collect money by begging/entreaty; summon/invite (persons) to a gathering;
conrotund	make round; round off; amass/make up a round sum of money;
conrug	make wrinkled; (make one turn up one's nose); corrugate;
conrutund	make round; round off; amass/make up a round sum of money;
consacr	consecrate/dedicate, set apart; hallow, sanctify; deify; curse; vow to a god;
consaept	surround with a wall/fence/hedge; enclose, fence; fence/hedge in;
consalut	hail/greet/salute (as); exchange greetings; greet/salute cordially (L+S);
consan	heal; make whole; make wholly sound (L+S);
consarcin	stitch/sew/patch together;
consauci	injure, wound severely;
consceler	stain with crime, pollute with guilt, dishonor, disgrace by wicked conduct;
conscribill	scrawl/scribble over/upon, cover with scribbling; mark by beating (L+S);
consec	dismember, chop/cut up/short/off/in pieces/deep; prune/top; lacerate; intersect;
consecr	consecrate/dedicate, set apart; hallow, sanctify; deify; curse; vow to a god;
consed	stop, check, allay; still, quiet (L+S);
consept	surround with a wall/fence/hedge; enclose, fence; fence/hedge in;
conserv	keep safe/intact, save (from danger); preserve, maintain; spare; keep/observe;
consider	examine/look at/inspect; consider closely, reflect on/contemplate; investigate;
consignific	be significant; convey extra meaning;
consign	(fix a) seal; put on record; indicate precisely/establish; attest/authenticate;
consimil	compare;
consoci	associate/join/unite (in), share; bring in close relation/alliance/partnership;
consolid	solidify, make solid/thick; merge (usufruct) attached property, consolidate;
consomni	dream of;
conson	sound/utter/make noise together, harmonize; resound/re-echo; agree;
conspir	plot/conspire/unite; sound/act in unison/harmony/accord; blow together (horns);
conspir	coil up;
conspiss	thicken; condense;
conspoli	rob;
conspurc	befoul, pollute; defile sexually;
consput	spit on/over; (in contempt);
constagn	cause to stand; congeal;
const	it is agreed/evident/understood/correct/well known (everyone knows/agrees);
constern	confound/shock/confuse/perplex/dismay; terrify/alarm/frighten, drive frantic;
constern	|overcome; stretch/lay out upon the ground; excite to sedition/revolt/mutiny;
constip	crowd together; press/crowd closely together (L+S);
const	agree/correspond/fit, be correct; be dependent/based upon; exist/continue/last;
const	|be certain/decided/consistent/sure/fixed/established/well-known/apparent/plain;
const	||stand firm/still/erect/together; remain motionless/constant; consist of/in;
constrict	draw together; (medical term associated with cauterization and amputation);
constupr	ravish, rape; debauch, defile, corrupt; have illicit (adultery/forcible) sex;
consud	sweat profusely/well/a lot; (also applied to packed olives/fruit);
consumm	add/reckon/total/sum/make up; finish off, end; bring about, achieve/accomplish;
consumm	|bring to perfection; put finishing/crowning touch; serve one's time; be grown;
consusrr	whisper together;
contabul	board over, cover with boards; furnish with roof/floor/bridge; build; bridge;
contamin	corrupt, defile (w/filth/intercourse), stain, befoul spoil; ruin, dishonor;
contamin	|debase w/mixture of inferior material; contaminate, infect; pollute (morally);
contemer	violate; defile, pollute; stain;
contemper	temper (by mixing) (drink); moderate (L+S);
contempor	be contemporary, be at the same time;
contenebr	grow dark;
conterebr	pierce/bore through;
conterit	frighten much/greatly/thoroughly, terrorize;
contermin	border on; be a borderer, have a common boundary;
contern	divide into groups of three; (persons);
conterrit	frighten much/greatly/thoroughly, terrorize;
contesser	contract friendship with tesserae (token divided between friends as sign);
contign	join/furnish with joists/beams; rafter, floor;
conton	it thunders violently/loudly/heavily;
contract	handle, finger, touch repeatedly; feel; handle unlawfully (theft/embezzlement);
contract	|caress/fondle, handle amorously; have sex with; deal with/handle/apply oneself;
contrect	touch repeatedly, handle, finger; feel; handle unlawfully (theft/embezzlement);
contrect	|handle amorously, caress/fondle; have sex with; deal with/handle/apply oneself;
contribul	crush, bruise; afflict much, crush;
contric	fritter away, waste;
contrist	sadden, make gloomy, depress, discourage; afflict, sap, damage (crops); darken;
contrucid	slaughter/butcher; cut/hew down/about; cut to/in pieces;
contrucid	|inflict many wounds on, kill large numbers; slay (L+S); put to the sword;
contrunc	hack/cut down/to pieces; gobble up, dispatch (food);
contumeli	insult; treat outrageously;
contumul	bury, inter; heap together; heap up like a mound (L+S); furnish with a mound;
conturb	confuse, disquiet/confound/derange/dismay, upset/mix up; go bankrupt, default;
conturm	arrange in turmae/squadrons (cavalry);
convalid	validate, make valid;
convall	surround with a rampart/entrenchment; hedge in; encircle, surround (L+S);
convari	vary, be different;
convari	spot, variegate;
convas	pack up (baggage); pack vessels/implements together (L+S); pile up;
convect	carry/bring together (in abundance); gather, collect;
convel	cover (over), veil; wrap around;
convenust	ornament, adorn;
converber	beat, batter; bruise; strike severely (L+S); chastise;
convex	jostle, push against; press/squeeze together (L+S);
convibr	move rapidly, flash; set in rapid motion; move something quickly/rapidly;
conviol	violate, desecrate (tomb/etc.);
conviser	incorporate, unite;
convivific	quicken together; revive, give/restore life together (physical/spiritual);
convoc	call/bring together; assemble; convoke/convene; summon/muster; collect (thing);
convolner	wound/inflict severe wounds (person/body part); cut; bore, perforate (pipe);
convol	fly/flock together; run together; assemble rapidly; have recourse to (w/ad);
convolut	revolve; whirl around; wallow in vice;
convolut	whirl/roll around rapidly?;
convor	eat up, devour;
convulner	inflict severe wounds (on person/part of body); cut; bore, perforate (pipe);
coopt	choose (colleague in office), elect; co-opt, admit;
coordin	coordinate, arrange together; set in order; correlate;
copt	choose (colleague in office), elect; co-opt, admit;
coquin	befoul/pollute/defile wholly; (coinquino); contaminate/taint/infect (w/disease);
coquin	cook, prepare food;
coquit	cook; boil, fry, bake; burn, parch (sun); stir up; ripen, mature (plot); digest;
coracin	caw (like a crow); croak (like a frog);
coron	wreathe, crown, deck with garlands; award prize; surround/encircle, ring round;
corpor	kill, strike dead; form into a body, furnish w/a body; form (corporate society);
corregn	reign together with one;
corrept	creep;
corresuscit	raise up/from the dead together;
corriv	lead/channel (water) into the same channel/basin, collect;
corrobor	strengthen, harden, reinforce; corroborate; mature; make powerful, fortify;
corrog	collect money by begging/entreaty; summon/invite (persons) to a gathering;
corrotund	make round; round off; amass/make up a round sum of money;
corrug	make wrinkled; (make one turn up one's nose); corrugate;
corrutund	make round; round off; amass/make up a round sum of money;
corusc	brandish/shake/quiver; flash/glitter, emit/reflect intermittent/quivering light;
cosider	examine/look at/inspect; consider closely, reflect on/contemplate; investigate;
cosign	(fix a) seal; put on record; indicate precisely/establish; attest/authenticate;
crass	thicken, condense, make thick;
credit	believe strongly;
cremit	burn; cremate;
crem	burn (to ash)/cremate; consume/destroy (fire); burn alive; make burnt offering;
cre	create/bring into being/make; procreate; beget/sire; give birth to;
cre	|produce/bear fruit; bring about; cause to grow; elect, appoint, invest;
cre	||institute; conjure up; (PASS) be born/spring from; be home/native of;
crepit	rattle/clatter; rustle/crackle; produce rapid succession of sharp/shrill noises;
crep	rattle/rustle/clatter; jingle/tinkle; snap (fingers); harp on, grumble at; fart;
crep	|crack; burst asunder; resound;
cress	increase (size/number/honor), multiply; thrive;
cribell	sift, pass through a sieve;
cribr	sift, pass through a sieve;
cris	move the haunches as in copulation (women); (rude);
crispic	curl (hair); make/appear wavy; ripple; shake/brandish; tremble/quiver; wiggle;
crisp	curl (hair); make/appear wavy; ripple; shake/brandish; tremble/quiver; wiggle;
criss	move the haunches as in copulation (women); (rude);
crocin	anoint with saffron-ointment;
crocit	croak/caw (like a raven); (loudly L+S);
croc	dye saffron-yellow;
crotaliss	clack/sound/rattle with castanets;
crotol	clack, make the characteristic sound of the stork;
cruci	torment, torture; cause grief/anguish; crucify; suffer torture/agony; grieve;
crudit	suffer from indigestion;
cruent	stain/spot/mark with blood; cause to bleed, wound; pollute with blood-guilt;
cruent	|make/dye blood-red; soak/besplatter with any liquid; tinge with red (L+S);
crumin	fill like a purse;
crust	encrust/cover w/layer/coating/plaster; emboss/carve/decorate w/relief/embossing;
crystalliz	crystallize;
cubit	recline, lie down, take rest, sleep; lie down often; lie/sleep (sexual);
cub	lie (down/asleep); recline, incline; lie/be in bed, rest/sleep; be sick/dead;
cucub	hoot; (of the screech owl);
cucul	utter the cry of the cuckoo;
cul	drive, thrust, shove; (perh. slang); push (one) by/in the culus (Sex rude);
culpit	censure, find fault with; blame/reproach severely/harshly (L+S);
culp	blame, find fault with, censure, reproach, reprove, disapprove; accuse, condemn;
cultell	measure horizontal distances over rough ground with vertical rods;
cultell	|make in shape of a knife; level ground by the coulter (vertical blade on plow);
cumul	heap/pile up/high, gather into a pile/heap; accumulate, amass; load/fill full;
cumul	|increase/augment/enhance; perfect/finish up; (PASS) be made/composed of;
cune	wedge in, secure by wedging; force in like a wedge; form a wedge, taper; mass;
curit	give frequent/abundant attention to; take care of, cherish (L+S);
cur	arrange/see/attend to; take care of; provide for; worry/care about; heal/cure;
cur	|undertake; procure; regard w/anxiety/interest; take trouble/interest; desire;
cursit	run about/to-and-fro/habitually; race/run races; resort frequently; be in motion
curs	run/rush/hurry to-and-fro/hither-and-thither; run constantly about; run over;
curt	shorten, cut short, abbreviate; diminish; circumcise; geld; dock (dog's tail);
curv	bend/arch, make curved/bent; form a curve; make stoop/bow/yield; influence;
cus	coin/stamp money;
cuspid	tip, provide with a point; make pointed (L+S);
cyathiss	ladle out wine; fill a cyathus/ladle (L+S);
cymbaliss	play/strike the cymbals;
damnific	injure; fine;
damn	pass/pronounce judgment, find guilty; deliver/condemn/sentence; harm/damn/doom;
damn	|discredit; seek/secure condemnation of; find fault; bind/oblige under a will;
dampn	pass/pronounce judgment, find guilty; deliver/condemn/sentence; harm/damn/doom;
dampn	|discredit; seek/secure condemnation of; find fault; bind/oblige under a will;
dapin	provide for; meet the cost of; serve up (as food) (L+S);
dat	be in habit of giving; make a practice of giving; give away, administer (L+S);
deacin	cleanse of grape-skins/etc.;
deaduoc	dis-avow;
dealb	whitewash; whiten (over); plaster, parget (L+S); purify, cleanse (eccl.);
deambul	take a walk, go for a walk; walk abroad (L+S); walk much; promenade;
deam	love dearly; be passionately/desperately in love with; be delighted with/obliged
deargent	take/deprive/strip of silver/money; (late) silver/plate over (L+S);
dearm	disarm; deprive of power; blunt;
deartu	dismember; rend limb from limb (L+S); ruin;
deasce	cut/shape smoothly; efface by cutting, rub out; get the better of; hew/cut w/ax;
deasci	cut/shape smoothly; efface by cutting, rub out; get the better of; hew/cut w/ax;
deaur	gild, gild over; (cover with gold leaf or plate);
debell	fight out/to a finish; bring a battle/war to an end; vanquish, subdue;
debilit	weaken/disable/incapacitate/impair/maim/lame/cripple; deprive of power (to act);
deblater	babble, utter in a foolish manner; blab out (L+S);
debri	intoxicate;
debuccin	trumpet forth;
debucin	trumpet forth;
decachinn	deride, laugh to scorn;
decacr	consecrate, dedicate; assign/devote (to purpose/function); deify (person) (L+S);
decacumin	top a tree; remove the crown of a tree by lopping;
decalautic	remove/relieve/deprive of a calautica (shoulder-length woman's headdress/hood);
decalc	plaster with lime; coat thoroughly with whitewash;
decalv	make bald, remove the hair; cut/shear off the hair;
decant	decant;
decant	chant, recite singing; reel off, repeat often/harp on; prattle; bewitch/enchant;
decapit	decapitate; behead;
decarmin	make prose of verse; disarrange the order of words (in a verse);
decarn	take off the flesh;
dececr	consecrate, dedicate; assign/devote (to purpose/function); deify (person) (L+S);
decemplic	multiply by ten;
decert	fight (issue out/to the finish); contend/dispute/argue; struggle/compete over;
decharmid	de-Charmidize, destroy identity as Charmides (character in Plautus' Trinummus);
decim	choose by lot every tenth man (for punishment); make tithe offering (to a god);
decircin	round off, make rounded/circular;
declamit	declaim (oratoric exercise) continually/habitually; practice rhetoric; bluster;
declam	declaim, make speeches (usu. as an oratorical exercise); bluster/bawl (L+S);
declar	declare/announce/make known; indicate, reveal, testify, show/prove; mean (word);
declin	deflect/divert/turnaside/swerve/change direction/deviate/dodge; digress/diverge;
declin	|avoid/stray; vary/be different; bend/sink down, subside/decline; lower/descend;
declin	decline/conjugate/inflect (in the same manner/like); change word form, modify;
decoll	trickle/drain away/from/through; drain (of); come to naught, fail (L+S);
decoll	behead, cause to be beheaded; remove from the neck (according to Nonius); rob;
decol	trickle/drain away/from/through; drain (of); come to naught, fail (L+S);
decolor	discolor/stain/deface, alter normal color of; disgrace, bring shame on; corrupt;
deconcili	extricate from trouble; deprive of, take away (L+S);
decori	skin, peel; deprive of skin or outer coating;
decor	adorn/grace, embellish/add beauty to; glorify, honor/add honor to; do credit to;
decortic	strip away the bark/rind; peel; scrape off (outer skin);
decrem	burn up; consume by fire;
decrimin	defame;
decrust	peel/split off; disintegrate;
decub	get down; (from a bed); lie away from/out of (one's bed) (L+S);
deculc	tread down, crush with the feet; trample upon (L+S);
decult	hide deeply, conceal vigorously;
decum	choose by lot every tenth man (for punishment); make tithe offering (to a god);
decuri	make (cavalry) squads of ten; organize in military fashion; enroll in decuria;
decurt	cut off/short, curtail; mutilate;
decuss	arrange crosswise; mark with a cross; divide crosswise (in form of X) (L+S);
dedecor	disgrace, dishonor; bring discredit/shame on; disfigure;
dedic	declare/proclaim; census return; dedicate/consecrate; devote/apply/commit (to);
dedol	cut down; hew smooth/away/to shape; beat/cudgel badly; (of sexual intercourse);
dedom	tame; (of horses);
deerr	go astray, wander off; miss, stray from target/goal; err/make a mistake/go wrong
defaec	strain/clear; cleanse, remove dregs/impurities from; defecate (L+S); set at ease
defaener	exhaust, bring ruin; (by the extortion of usury);
defatig	tire (out), exhaust; break force of; (PASS) lose heart, weary, be discouraged;
defec	strain/clear; cleanse, remove dregs/impurities; defecate (L+S); set at ease;
defendit	make practice of defending (legal cases); defend often/habitually (contentions);
defener	exhaust, bring ruin; (by extortion of usury); involve in debt;
defens	defend/guard/protect against; act in defense against; ward off; avert constantly
defetig	tire (out), exhaust; break force of; (PASS) lose heart, weary, be discouraged;
defic	deify, make one a god;
defic	strain/clear/cleanse, remove dregs/impurities from; defecate (L+S); set at ease;
deflagl	be burnt down/destroyed by fire; perish; be (emotionally/physically) burnt out;
deflagl	burn down/up/destroy by fire/utterly; parch (sun); die down/abate, burn out;
deflagr	be burnt down/destroyed by fire; perish; be (emotionally/physically) burnt out;
deflagr	burn down/up/destroy by fire/utterly; parch (sun); die down/abate, burn out;
deflamm	extinguish, put out (the flame of); deprive of flame (L+S);
defl	blow away, blow on (for purpose of cleansing); brush/blow aside/off;
deflocc	rub the nap of (cloth); strip of possessions, fleece;
deflor	pluck flowers; deflower/dishonor/ravish/seduce (virgin); cull/excerpt;
defoed	defile;
deforci	deforce; keep by force/violence; withhold wrongfully;
deform	design/shape/fashion/model; outline; describe, sketch in words, delineate;
deform	|disfigure, spoil, impair; (appearance); discredit, disgrace, bring shame on;
deform	|transform (into something less beautiful); lay out, arrange (plan of action);
defraud	cheat, defraud, deceive; rob (of); [w/se => deny oneself, self-sacrifice];
defric	rub hard/thoroughly; (ointment); rub down (person/beast); scour/rub off;
defric	rub hard/thoroughly; (ointment); rub down (person/beast); scour/rub off;
defrud	cheat, defraud, deceive; rob (of); [w/se => deny oneself, self-sacrifice];
defrug	rob of grain; sow too little grain;
defrust	divide into pieces, dismember;
defrut	boil down (grape juice) into defrutum/syrup;
defug	drive away; remove;
defulgur	flash away;
degener	be inferior to ancestors/unworthy; deteriorate/decline; lower oneself;
degener	|sink (to); fall away from/below the level; degenerate/revert (breeding);
degener	be unworthy (of), fall short of the standard set by; cause deterioration in;
deglabr	make smooth; (remove bark from trees/logs); smooth off (L+S);
deglutin	unglue; separate by moistening (L+S);
degrad	reduce in rank; deprive of office; degrade;
degrandin	it goes on hailing; it hails violently, or (perhaps) it ceases to hail (Cas);
degrav	weigh/press/drag down; rest heavily on; overpower, overwhelm; burden;
degul	devour, swallow down; consume (L+S);
degun	taste; taste/try/eat/drink a little of; glance at; graze; sip; test; judge;
degust	taste; taste/try/eat/drink a little of; glance at; graze; sip; test; judge;
dehonest	dishonor, discredit, disgrace; disparage (L+S);
dehonor	dishonor;
deific	deify; make one a god
deintegr	impair; deprive of integrity; destroy (L+S);
deject	hurl down violently; (intensive verb);
dejer	swear, take an oath;
dejudic	give final judgment on (question);
dejug	disconnect; disunite; separate (L+S); sever;
dejur	swear, take an oath;
dejuv	withhold assistance; leave off helping;
delabor	work hard; overwork (L+S);
delacer	tear to shreds/pieces; destroy, frustrate (L+S);
delacrim	shed tears; leek sap (trees); weep (L+S);
delacrum	shed tears; leek sap (trees); weep (L+S);
delaev	smooth down/off; make smooth (L+S);
delapid	pave over/lay with stones; remove stones from; clear from stones (L+S);
delass	tire out, weary, exhaust; exhaust by experiencing;
delav	wash off; wash clean;
deleg	assign/appoint; delegate/entrust (to); consign; transfer/pass; refer/attribute;
deler	be mad/deranged/silly; dote; speak deliriously, rave; deviate from balks (plow);
delev	smooth down/off; make smooth (L+S);
deliber	weigh/consider/deliberate/consult (oracle); ponder/think over; resolve/decide on
delib	skim/flake/scrape off; channel off (water); pick out a choice specimen; perform;
delib	|diminish/detract (from); take away a little as to render imperfect; infringe;
delib	|take a little, wear away, nibble at; taste (of), touch on (subject) lightly;
delibr	peel, remove/strip the bark (from); strip/take off (bark); (rind L+S);
delic	reveal, disclose; make clear, clarify, explain;
delig	bind fast, tie (up), fasten; make fast by tying; bandage; tie (bandage);
delimit	delimit, mark out the boundaries of;
delim	file down; produce by filing;
deline	delineate; trace the outline of; (sketch out L+S);
delini	delineate; trace the outline of; sketch out (L+S);
deliqu	strain (liquid to clear); strain off (solid matter); make clear; clarify/explain
delir	be mad/crazy/deranged/silly; speak deliriously, rave; deviate from balks (plow);
delitig	dispute wholeheartedly; have it out; scold, rail angrily (L+S);
delumb	injure (by dislocating hip); bring down on haunches; lame, weaken; bend/curve;
delustr	disenchant, free from an evil charm/spell/enchantment;
delut	plaster/daub with (preparation of) clay;
demand	entrust, hand over (to), commit; lay (duty on a person), charge (that);
deman	run/flow down; percolate; flow different ways (L+S); descend; descend from;
dement	drive mad/crazy; bewitch; delude; rave, be out of one's mind;
deme	descend, go down;
demigr	emigrate; migrate; depart/remove/withdraw/go away (from situation/local/thing);
deminor	lessen, diminish; (in honor/rank);
demitig	calm (person) down; (PASS) become milder/more lenient (L+S);
demonstr	point out/at/to, draw attention to; explain/describe/show, give an account of;
demonstr	|reveal, mention, refer to; allege; prove, demonstrate; represent; recommend;
demorsic	bite pieces off; nibble at; bite off;
demorsit	bite pieces off; nibble at; bite off;
demurmur	mutter (set of words) through; mutter over (L+S);
demuss	swallow/bear/endure in silence;
demutil	lop off;
demut	change/alter/transform; deviate from way/goal, fail; depart/be different from;
denarr	tell/relate fully/in full; give a full account of; recount, narrate (L+S);
denas	remove the nose (from a person's face); deprive of the nose (L+S);
denat	swim downstream; swim down (L+S);
denavig	sail down;
deneg	deny (fact/allegation); say that ... not; deny/refuse (favor/request);
denigr	blacken, make black; color very black, blacken utterly (L+S); asperse, defame;
denomin	denominate, designate; give a name to (usu. from source expressed/implied);
denorm	put out of shape; make crooked/irregular; disfigure (L+S);
denot	mark (down); lay on (color); observe; indicate/point out; imply; brand; censure;
dens	thicken/condense/concentrate/compress/coagulate; press/pack/crowd together;
denud	strip, denude, lay bare, uncover; reveal/disclose; expose; rob/plunder/despoil;
denumer	pay (money) in full; pay down (loan);
denunti	give notice, warn/foretell; threaten/enjoin/declare intent to injure; intimate;
denunti	|announce, give official information; declare; summon (witness)/deliver summons;
deocc	harrow, run the harrows over (crop to remove weeds and ventilate the soil);
deoner	unload, unburden, remove (burden);
deopt	choose, select;
depalm	slap, strike with the open hand; box on the ear (L+S);
depal	bound/mark off with stakes/palings; found, establish (L+S); (long a);
depal	disclose, reveal;
depauper	impoverish;
depil	strip hair/feathers; pull out hair; pluck feathers; peel skin; plunder, cheat;
deplac	appease, propitiate;
deplan	level off, make level/even;
deplant	sever/break off (twig/branch/shoot); plant/set in the ground (L+S);
deplor	weep/lament/mourn for/cry over; deplore, complain of; lose; despair/give up on;
depocl	ruin by expenditure on cups/drinking;
depocul	ruin by expenditure on cups/drinking;
depomp	dishonor; deprive of ornament;
deponder	weigh down, press down by its weight;
depont	throw from a bridge;
deport	bring, convey (to); carry along/down (current); transport; take/bring home;
depostul	demand, press for; require earnestly (L+S);
depraedic	preach against;
deprav	distort/deform/twist, make crooked; mislead/pervert; deprave, corrupt;
depreci	depreciate, lower the value of;
depreti	depreciate, lower the value of;
deproper	hurry/hasten/make haste to complete/finish (w/INF); prepare hastily (L+S);
depudic	violate, dishonor; deflower, deprive of virginity (Sex);
depugn	fight hard/it out, do battle; fight against and kill (in arena); stop fighting;
depulp	grow lean/thin; lose flesh;
depuls	push/thrust away; push aside (L+S);
depurg	clean out/away (impurities), remove dirt/offal from; rid (things of); purge;
depur	purify; refine; clear, discharge (of debt);
deput	prune/cut away/back; regard/esteem; define as/assign to/classify; post/second;
derain	deraign; establish title; vindicate;
deration	prove; establish; deraign; disarrange; E:be discharged (from monastic order);
deriv	draw/lead off (river/fluid), divert/turn aside; derive/draw on; form derivative;
derogit	ask urgently;
derog	subtract/remove/diminish/detract; disparage; repeal/set aside/modify (law);
deruncin	plane off, shave; cheat, fleece; deceive;
desacrific	dedicate as a sacrificial victim;
desalt	dance through; perform w/dance; represent in dance (L+S); dance the part of;
descobin	scrape, graze; scrape/rasp/file off/away;
descrob	set (jewel in setting); enchase, deeply engrave; ornament;
desec	sever; cut off (limb/boundary); cut/carve from/out/away; cut/reap/mow (crop);
desicc	dry (up), drain dry; desiccate (L+S);
desic	sever; cut off (limb/boundary); cut/carve from/out/away; cut/reap/mow (crop);
desider	desire/want, long/wish for, request, require/need; miss, lack; lose;
desider	|want to know; investigate/examine/discuss (L+S); raise the question;
design	mark; point/mark/trace out, outline/describe; indicate/designate/denote;
design	|earmark/choose; appoint, elect (magistrate); order/plan; scheme. perpetrate;
desin	stop/end/finish, abandon/leave/break off, desist/cease; come to/at end/close;
desol	forsake/abandon/desert; leave alone/without; empty of people; deprive/rob;
despect	look over/down at, survey; overlook; rise above, overtop; despise/look down on;
despecul	steal/rob of a mirror;
desper	despair (of); have no/give up hope (of/that); give up as hopeless (of cure);
despons	betroth, promise in marriage;
despum	skim, remove/draw froth/foam/scum (from); stop foaming, settle; deposit foam;
desquam	scale, remove scales/skin/surface from; peel/rub/scour/clean/scrape/shake off;
destic	squeak; (of the noise made by the shrew-mouse);
destill	drip/trickle down; wet/sprinkle; distill; have dripping off; fall bit by bit;
destimul	goad hard/on; stimulate (L+S);
destin	fix/bind/fasten down; fix (in mind), make up mind; aim/fix on target, mark out;
destin	|determine/intend; settle on, arrange; design; send, address, dedicate (Bee);
destrangul	choke, strangle; destroy;
desubul	make by piercing; bore in deeply (L+S);
desud	exert oneself;
desud	sweat/perspire/exude (freely); sweat, exert oneself (physical/mental effort);
desulc	plow up; furrow through (L+S);
desult	leap down (into/onto);
detens	shear off;
deterior	make worse; deteriorate;
deterior	deteriorate, make worse;
determin	delimit/bound, set bounds to; fix temporal limits of; confine within limits;
determin	|define; designate, mark out; determine linear extent of; conclude/end/settle;
deton	thunder, thunder down/forth; roar out; expend one's thunder, exhaust one's rage;
deton	|cease thundering/raging;
detons	clip, shear, crop/prune; shear off (wool), strip off (foliage), cut off/short;
detorn	turn, make by turning on lathe;
detors	shear off;
detract	refuse (to undertake/undergo), decline, reject, evade, recoil from;
detract	|disparage/belittle, speak/write slightingly of; reduce/depreciate/detract from;
detrect	refuse (to undertake/undergo), decline, reject, evade, recoil from;
detrect	|disparage/belittle, speak/write slightingly of; reduce/depreciate/detract from;
detriumph	conquer; triumph over;
detrunc	mutilate, cut pieces from; lop off, cut off; remove branches from; maim; behead;
deturb	upset/topple, bring tumbling down; dislodge; strike/beat to ground;
deturb	|drive/pull/knock/cast/thrust/strike down/off; deprive of;
deturp	disfigure, ruin appearance of; discredit; disparage; defile;
devast	devastate, lay waste (territory/people); ravage; slaughter;
devect	carry away;
devel	uncover; unveil (L+S);
devenust	disfigure; mar the beauty of; deform (L+S);
deverber	thrash; flog/whip soundly; cudgel/beat soundly (L+S);
deversit	turn aside and linger (over); put up at an inn (L+S); dwell upon;
devex	drag about; pull this way and that; harass/harry/vex/trouble;
devex	|ravage/plunder; tear/rend/pull/rip apart/asunder, destroy (L+S);
devi	detour; stray; depart;
devirgin	deflower, deprive of virginity; violate, ravish; grow up, quit youth (PASS L+S);
devit	avoid; get/keep clear of; shun (L+S); go out of the way of; dodge/duck/evade;
devoc	call down (from above); call away/off, summon/divert (from activity/situation);
devoc	|call; sue; impede; disavow, deny;
devol	fly/swoop/drop down (on to); hurry/rush/hasten/fly down/away (to);
devor	devour, consume; swallow, gulp down; engulf/ingulf, absorb, drink in;
devor	|use up; waste; swallow, endure, put up with; repress/suppress, check (emotion);
devot	bewitch; put a spell on; curse;
dibal	blab; bleat out;
dibucin	trumpet forth; trumpet in different direction;
dic	dedicate/consecrate; deify; devote; attach to another state; assign; show;
dictit	repeat; persist in saying, keep on saying/speaking of; say/plead/call often;
dict	dictate (for writing/speaking); compose; draw up; order/prescribe; fix (survey);
dict	|say/declare/assert repeatedly/habitually/often/frequently; reiterate; recite;
didascul	teach, instruct
diffam	defame, slander; spread news of, publish abroad/widely, publish/divulge (L+S);
diffibul	unfasten; unbuckle (L+S); unclasp;
difflagit	importune, pester; dun, press, beset;
diffl	blow away, scatter/disperse by blowing; blow apart (L+S);
diffluvi	divide and spread out; split (L+S); divide/branch (into two streams);
diffring	shatter; break up/apart/in pieces;
diffug	scatter, disperse, dispel; put to flight; rout;
diffulgur	scatter lightning/thunderbolts around/abroad;
diffulmin	scatter (as) with a thunderbolt/lightning;
diffumig	fumigate;
diffundit	dissipate; squander, waste, throw away;
difring	shatter; break up/apart/in pieces;
dignor	distinguish; know apart, make distinction, separate;
dijudic	decide, settle (conflict); adjudicate/judge; distinguish (between), discern;
dijug	separate;
dilacer	tear to pieces, tear in pieces; tear apart;
dilamin	split in two (?);
dilani	tear to pieces; shred; rend/pull asunder;
dilapid	bring (edifice) to partial ruin; pelt/shower w/stones;
dilapid	|squander; throw away; scatter like stones; consume; destroy;
dilat	widen/broaden, expand/enlarge/extend/spread/dilate; prolong; flatten/roll out;
dilat	|exaggerate, magnify; fill out; express more fully; pronounce more broadly;
dilaud	praise expansively/widly/highly/much/in all respects; be grateful to (Ecc);
dilax	stretch apart;
dilig	bind fast, tie (up), fasten; make fast by tying; bandage; tie (bandage);
dilini	disturb, harass; torment mentally;
diloric	tear/pull apart/open; (of garment covering breast);
dilucul	it dawns, it becomes/grows light;
diluvi	flood, inundate; deluge (L+S);
diman	run/flow down; percolate; flow different ways (L+S); descend; descend from;
dimic	fight, battle; struggle/contend/strive; brandish weapons; be in conflict/peril;
dimic	fight, battle; struggle/contend/strive; brandish weapons; be in conflict/peril;
dimidi	halve, divide in half/two; divide into two equal parts (L+S);
dinot	mark with a distinctive label;
dinumer	count, calculate (number of); enumerate; reckon; count/pay out (money);
dirar	thin out (vegetation); chop, hoe;;
diration	deraign; establish title; vindicate; decide/adjudge; [~ me => clear oneself];
diriv	draw/lead off (river/fluid), divert/turn aside; derive/draw on; form derivative;
disam	love dearly;
discapedin	separate (the hands so as to use independently); hold hands apart (L+S);
discept	dispute; debate; arbitrate;
discord	be at variance, quarrel; be different;
discrep	it is undecided/disputed/a matter of dispute; there is a difference of opinion;
discrep	it is undecided/disputed/a matter of dispute; there is a difference of opinion;
discrep	disagree/differ/vary; have differences/discrepancies/difference of opinion;
discrep	|be out of tune; differ in sound; be out of harmony/inconsistent with;
discrep	disagree/differ/vary; have differences/discrepancies/difference of opinion;
discrep	|be out of tune; differ in sound; be out of harmony/inconsistent with;
discrimin	divide up, separate;
discruci	torture;
disculci	unshoe; remove the shoe from;
disgreg	separate; divide; disperse, scatter, divide; rend asunder; break up;
disjug	separate;
dismembr	dismember; separate, break up; distribute;
dispar	separate, divide;
dispens	manage; dispense, distribute; pay out; arrange;
dispoli	rob/plunder; despoil (of); strip, deprive of clothing/covering; (for flogging);
dispons	give in marriage; (desponso);
disput	discuss, debate, argue;
disrar	thin out (vegetation); chop, hoe;;
disration	deraign; put into disorder; disarrange; be discharged from order (eccles.);
dissec	dissect;
dissec	cut apart; cut in pieces; dismember, dissect;
dissemin	broadcast, disseminate;
disseren	it is clearing up all round; (of the weather);
dissert	discuss;
dissic	cut apart; cut in pieces; dismember, dissect;
dissign	mark; point/mark/trace out, outline/describe; indicate/designate/denote;
dissign	|earmark/choose; appoint, elect (magistrate); order/plan; scheme. perpetrate;
dissil	be torn apart;
dissimul	conceal, dissemble, disguise, hide; ignore;
dissip	scatter, disperse, dissipate, squander; destroy completely; circulate;
dissoci	be/set at variance with, split into factions, separate, part;
dissult	fly or burst apart; bounce off;
dissup	scatter, squander; destroy completely; circulate; (alt. form of dissipo);
distermin	divide from, serve as boundary; divide up; mark off w/boundary; separate from;
distill	drip/trickle down; wet/sprinkle; distill; have dripping off; fall bit by bit;
distimul	goad hard/on; stimulate (L+S);
dist	stand apart, be distant; be different;
disturb	disturb, demolish, upset;
dit	enrich;
ditt	repeat; declare;
divaric	stretch apart, spread out;
diverber	split; strike violently;
diversific	vary, be different; diversify;
divers	turn around; diversify;
divex	drag about; pull this way and that; harass/harry/vex/trouble;
divex	|ravage/plunder; tear/rend/pull/rip apart/asunder, destroy (L+S);
divin	divine; prophesy; guess;
divulg	publish, disseminate news of;
d	give; dedicate; sell; pay; grant/bestow/impart/offer/lend; devote; allow; make;
d	|surrender/give over; send to die; ascribe/attribute; give birth/produce; utter;
dogmatiz	propound a dogma; dogmatize(Latham);
dol	hew/chop into shape, fashion/devise; inflict blows, batter/cudgel soundly, drub;
domit	tame, break in;
dom	subdue, master, tame; conquer;
don	present, grant; forgive; give (gifts), bestow;
dormit	feel sleepy, drowsy; do nothing;
dot	provide with a dowry, endow;
dubit	doubt; deliberate; hesitate (over); be uncertain/irresolute;
duct	lead;
duell	duel;
dulc	sweeten;
dulcor	sweeten;
duplic	double, bend double; duplicate; enlarge;
dur	harden, make hard; become hard/stern; bear, last, remain, continue; endure;
ebull	spout out; chatter about; burst/break/send out; [animam ~ => expire];
ebull	|bubble; boil-up; produce in abundance;
edissert	relate, expound; explain;
ed	eject/emit; put/give forth (buds); beget; bear (fruit); display/evince/exhibit;
ed	|utter solemnly; pronounce/decree (oracle); deliver (message); issue (command);
ed	||publish; disclose, tell, relate, make known; declare, make formal statement;
ed	|||cause; see birth of; be birthplace/breeding ground of; debouch (river PASS);
ed	||||bring forth,  produce/yield (crops), give birth to (often PASS PERF VPAR);
ed	|||||notify of suit; nominate for jury; appoint/set (a time); bring witnesses;
ed	||||||present (documents for inspection; put on (play); hold (banquet); uplift;
edol	hack, hew, hew out; form by hacking; plane (Ecc);
edom	subdue/tame thoroughly/completely, subjugate/conquer/vanquish;
edom	|master (vices); overcome (difficulties); bring (land /plants)under cultivation;
educ	bring up; train; educate; rear;
edulcor	sweeten;
effemin	weaken, enervate, make effeminate, emasculate, unman;
effer	make wild/savage/barbaric; brutalize; exasperate;
effigi	form; fashion; portray;
efflagit	request, demand, insist, ask urgently;
effl	blow or breathe out; breathe one's last;
efform	form, shape, fashion;
effren	unbridle, let loose; remove or slacken the reins of a horse;
effug	drive away (from); frighten off, deter; drive/send into exile;
eier	refuse upon/reject by oath; abjure, resign, abdicate, renounce;
eject	cast out;
ejul	wail, lament;
ejur	abjure; resign; reject on oath (of a judge); forswear, disown;
elabor	take pains, exert oneself; bestow care on;
electrific	electrify;
electris	charge;
elev	lift up, raise; alleviate; lessen; make light of;
elimin	carry out of doors; [w/dicta => to blab];
elim	make/remove by filing; polish w/file; file off; produce/write w/care/polish;
eliqu	refine (an industrial product);
elonginqu	remove;
elong	withdraw, depart; remove; keep aloof;
elucid	light; enlighten;
emacul	cleanse of stains/spots, make clean; heal; correct/clear from faults (Erasmus);
emancip	emancipate (son from his father's authority); alienate; make subservient;
eman	flow out; arise, emanate from, become known;
emendic	beg, solicit, obtain by begging;
emend	correct, emend, repair; improve, free from errors;
emic	leap/dash/bolt/jump/spurt/burst/break/shine out; spring/dart/shoot forth/up;
emic	|appear suddenly/quickly; make sudden movement up/out; give a jump; stand out;
emigr	move out; depart;
emplastr	bud (trees);
emund	clean thoroughly, free of dirt/impurity; make quite clean (L+S); cleanse/purify;
enarr	describe; explain/relate in detail;
enat	escape by swimming;
enavig	sail forth/away, put out to sea; sail clear (of obstacles) sail across; swim;
encaeni	consecrate; put on something new;
enec	kill/slay; deprive of life; kill off; exhaust/wear out, plague/torture to death;
enec	kill/slay; deprive of life; kill off; exhaust/wear out, plague/torture to death;
enerv	weaken, enervate; make effeminate; deprive of vigor; cut/remove sinews from;
enic	kill/slay; deprive of life; kill off; exhaust/wear out, plague/torture to death;
enic	kill/slay; deprive of life; kill off; exhaust/wear out, plague/torture to death;
en	swim out;
enod	make clear;
enubil	make clear;
enucle	take out the kernel/nut, shell; explain in detail;
enumer	count up, pay out; specify, enumerate;
enunti	reveal; say; disclose; report; speak out, express, declare;
enunti	reveal/divulge/make known/disclose; speak out, express/state/assert; articulate;
e	go, walk; march, advance; pass; flow; pass (time); ride; be in the middle;
epitom	abridge, epitomize;
epot	drink down/up, quaff, drain; absorb; swallow/suck up; empty (vessel); engulf;
epot	drink down/up, quaff, drain; absorb; swallow/suck up; empty (vessel); engulf;
equit	ride (horseback);
eradic	root out,eradicate;
erog	pay out, expend;
err	wander, go astray; make a mistake, err; vacillate;
eruct	bring up noisily; discharge violently;
eructu	gush forth;
eruder	clear from rubbish;
erug	take wrinkles/creases from;
essentific	make real; endow with essence;
essoni	essoin, excuse court absence;
estim	value; estimate;
evacu	empty (vessel); purge, evacuate (bowels);
evagin	unsheathe;
evangeliz	preach/declare/proclaim (the Gospel); evangelize, win to Gospel by preaching;
evast	devastate;
eventil	winnow thoroughly; fan away; fan (L+S); set in motion (air);
everber	beat violently;
evigil	be wakeful; watch throughout the night; devise or study with careful attention;
evir	deprive of virility; weaken;
eviscer	disembowel; eviscerate;
evit	shun, avoid;
evoc	call forth; lure/entice out; summon, evoke;
evol	fly away, fly up/out/forth; rush out/forth;
evulg	make public, divulge;
exacerb	irritate/exasperate, enrage/provoke; aggravate/make worse; grieve, afflict;
exaedific	complete the building of, construct;
exaequ	equalize, make equal; regard as equal; be equal (to);
exaestu	boil up; seethe, rage;
exagger	heap up, accumulate; magnify;
exagit	drive out; stir up, disturb continually, harass; attack, scold, discuss;
exalt	exalt, elevate, raise; praise; deepen;
examin	weigh, examine, consider;
exanim	kill, deprive of life; scare, alarm greatly; tire, exhaust; be out of breath;
exantl	exhaust; endure; bar; suffer much from toil;
exarm	disarm, deprive of weapons/arms; weaken, deprive of military strength;
exarm	|dismantle/remove ship's tackle; deprive beasts of their natural weapons;
exar	plow or dig up; plow; note down (by scratching the wax on the tablets);
exasper	roughen; irritate;
exati	satisfy, satiate; glut;
exauctor	release or dismiss from military service;
excaec	blind (completely), confuse/hide/obscure; dull/dim; block channel; de-eye plant;
excalci	remove the shoes from;
excardin	excardinate; (transfer of cleric to another diocese/consecrated life);
excarnific	torture, punish; torment/torture mentally; hack/cut/tear to pieces (L+S);
excav	hollow/scoop out, make hollow; produce/make/form by excavation/hollowing out;
except	take out, take up; inhale, take (to oneself);
excerebr	brain, bash the head in; deprive of brains; make senseless; stupefy;
excit	wake up, stir up; cause; raise, erect; incite; excite, arouse;
exclam	exclaim, shout; cry out, call out;
excogit	think out; devise, invent, contrive;
excommunic	excommunicate; (exclude Catholic from communion w/faithful);
excori	strip of skin/covering; flay, skin, strip;
excruci	torture; torment;
excub	sleep/lie in the open/out of doors; keep watch; be attentive;
exculc	trample down;
excus	excuse/justify/explain; make excuse for/plead as excuse; allege; absolve/exempt;
excuss	excuse/justify/explain; make excuse for/plead as excuse; allege; absolve/exempt;
exec	cut out/off; remove/make (hole) by cutting; cut, make cut in; castrate;
exempl	adduce/serve as example/model/pattern; form after a pattern;
exenter	disembowel;
exercit	practice, exercise, train hard, keep at work;
exerr	wander off (from one's course);
exert	stretch out; uncover;
exhal	breathe out; evaporate; die;
exheredit	disinherit;
exhered	disinherit;
exhilar	gladden, cheer; brighten, spruce up, enhance appearance;
exhonor	dishonor; despise;
exicc	dry up; empty (vessel);
exic	cut out/off; remove/make (hole) by cutting; cut, make cut in; castrate;
existim	value/esteem; form/hold opinion/view; think/suppose; estimate; judge/consider;
existum	value/esteem; form/hold opinion/view; think/suppose; estimate; judge/consider;
exocul	blind, put out/deprive of eyes/sight;
exoner	unload, disburden, discharge;
exopt	long for;
exorbit	derail;
exorciz	exorcise;
exorn	furnish with, adorn, embellish;
exor	persuade, obtain/win over by entreaty, prevail upon; beg, plead, entreat;
exoss	bone/de-bone, take out the bones, filet;
expalp	coax out;
expect	await, expect; anticipate; hope for;
expector	banish from mind;
expil	plunder, rob, despoil;
expi	expiate, atone for; avert by expiatory rites;
expir	breathe out; exhale; expire; die; cease;
explan	explain;
explant	uproot, pull up/out/off (plant/shoot); cast out (Ecc);
explic	unfold, extend; set forth, display, exhibit, explain, disentangle;
explic	unfold, extend; set forth, explain;
explor	search out, explore; test, try out; reconnoiter, investigate;
expoli	plunder;
export	export, carry out;
expostul	demand, call for, remonstrate, complain about;
exprobr	reproach, upbraid, reprove; bring up as reproach (against person DAT);
expugn	assault, storm; conquer, plunder; accomplish; persuade;
expurg	cleanse, purify; exculpate;
exsati	satisfy, satiate; glut;
exsatur	satisfy, sate, glut;
exscre	cough out/up;
exsec	cut out/off; remove/make (hole) by cutting; cut, make cut in; castrate;
exsert	stretch out; uncover;
exsicc	dry up; empty (vessel);
exsic	cut out/off; remove/make (hole) by cutting; cut, make cut in; castrate;
exspect	lookout for, await; expect, anticipate, hope for;
exspir	breathe out, exhale; expire; cease, die;
exspoli	pillage, rob, plunder;
exstern	terrify greatly, frighten; madden;
exstimul	goad; stimulate;
exstirp	root out, extirpate; pull/pluck out/up by roots; eradicate root and branch;
exst	stand forth/out; exist; be extant/visible; be on record;
exsud	exude; sweat out;
exsuffl	blow at/upon; blow away;
exsufl	blow at/upon; blow away; (exsufflo with 1 f - Whitaker);
exsul	be exile, live in exile; be banished; be a stranger;
exsult	rejoice; boast; exalt; jump about, let oneself go;
exsuper	excel; overtop; surpass; overpower;
exsurd	deafen; make dull or blunt (taste);
exsuscit	awaken; kindle; stir up, excite;
extenter	cut open;
extenu	make thin; diminish;
extermin	banish, expel; dismiss;
extern	terrify greatly, frighten; madden;
extimul	goad; stimulate;
ext	stand out or forth, project be visible, exist, be on record;
extric	disentangle, extricate, free;
exturb	drive away, put away a wife;
exuber	surge or gush up; be abundant, be fruitful;
exud	exude; sweat out;
exul	be exile, live in exile; be banished; be a stranger;
exult	jump about; let oneself go; exult;
exulul	invoke with howls;
exund	gush forth; overflow with;
exuper	excel; overtop; surpass; overpower;
factit	do frequently, practice;
falsific	falsify;
fals	falsify;
fan	dedicate; consecrate;
fascin	cast a spell on, bewitch;
fastig	make pointed; slope to point; exalt to high;
fastig	|exhaust; intoxicate;
fatig	weary, tire, fatigue; harass; importune; overcome;
febricit	have fever, be feverish, be ill of a fever;
fecund	make fertile/fruitful;
fefell	be failed(by); be disappointed(with);
fellat	suck (milk) (from); fellate, practice fellatio; (active participant);
fellic	suck (milk) (from); fellate, practice fellatio; (active participant);
fellit	suck (milk) (from); fellate, practice fellatio; (active participant);
fell	suck (milk) (from); fellate, practice fellatio; (active participant);
fel	suck (milk) (from); fellate, practice fellatio; (active participant);
feoff	enfeoff, infeft (Scot.); invest with fief; put in legal possession;
ferit	strike, deal blows; fight;
ferment	leaven; cause fermentation in; aerate (soil);
ferrumin	cement, solder; glue; bind;
ferumin	cement, solder; glue; bind;
festin	hasten, hurry;
fetific	breed/spawn; hatch/bring forth offspring/young;
fet	breed/spawn; hatch/bring forth offspring/young; impregnate, make fruitful (L+S);
fibul	join; bond; knit together; fasten; buckle up/together;unfasten; unbuckle;
figur	form, fashion, shape;
firm	strengthen, harden; support; declare; prove, confirm, establish;
flagell	flog, whip, lash, scourge; strike repeatedly; thresh/flail (grain); whip up;
flagit	demand urgently; require; entreat, solicit, press, dun, importune;
flagr	be on fire; blaze, flame, burn; be inflamed/excited;
flammiger	flame; blaze;
flammiger	flame; blaze;
flamm	inflame, set on fire; excite;
fl	breathe; blow;
fluit	float; flow; waver;
focill	warm up, refresh by warmth;
focil	revive, restore to health/consciousness; keep alive; cherish, tend, foster;
fodic	dig, jog; [w/latus => dig in the ribs];
foeder	seal; ratify (an agreement); establish by treaty/league (L+S);
foed	defile; pollute; soil, stain, make filthy/unclean; contaminate; corrupt;
foed	|disgrace/dishonor; bring shame, discredit; sully/besmirch (person/reputation);
foed	||disfigure, mar, spoil appearance/brightness/clearness/purity of; darken, dim;
foed	|||make (punishment) horrible/barbarous; mangle/hack/mutilate, ravage (land);
foetific	breed/spawn; hatch/bring forth offspring/young;
foet	breed/spawn; hatch/bring forth offspring/young; impregnate, make fruitful (L+S);
formid	dread, fear, be afraid of; be afraid for (the safety of) (w/DAT);
form	form, shape, fashion, model;
fortific	strengthen, fortify, make strong;
fortun	make happy, bless, prosper;
fragr	smell strongly;
fraud	cheat/defraud/swindle; deprive deceitfully; baffle, make ineffectual; dishonor;
fraud	|embezzle, take (money) dishonestly, steal; violate; evade/trick intent of law;
fren	brake, curb, restrain, check;
frequent	frequent; repeat often; haunt; throng; crowd; celebrate;
fric	rub, chafe;
fri	rub; crumble;
frix	thoroughly roast;
from	throw up;
fructifer	bear fruit; (Vulgate 4 Ezra 16:25/26);
fructific	sprout, produce new growth (plants); bear (new) fruit (L+S); increase (Douay);
fuc	color; paint; dye;
fug	put to flight, rout; chase away; drive into exile;
fulgur	glitter/flash/shine brightly, gleam; light up; (IMPERS) it lightens;
fulmin	lighten; cause lightning to strike; strike like lightning;
fumific	smoke (a cigar);
fumig	smoke (kitchen);
fumig	smoke, fumigate; treat with/subject to smoke; produce smoke (L+S); steam;
fum	smoke, steam, fume, reek;
fund	establish, found, begin; lay the bottom, lay a foundation; confirm;
funer	bury solemnly, inter with the funeral rites;
funest	pollute by murder;
furcill	support;
furi	madden, enrage;
fusc	darken, blacken, make dark; (INTRANS) become dark;
gale	cover with a helmet;
gargariss	gargle;
gargariz	gargle;
gel	cause to freeze; (pass.) be frozen, be chilled;
gemin	double; repeat; double the force of; pair (with);
gemm	bud, come into bud, put out buds;
gener	beget, father, produce, procreate; spring/descend from (PASSIVE);
germin	sprout forth;
gestit	carry often; wear often;
gest	bear, carry; wear;
glaci	freeze;
glomer	collect, amass, assemble; form into a ball;
glorific	glorify; magnify, honor, worship (Def); exalt in thought/speech; uplift;
glutin	glue; B:join (espec. wounds);
graeciss	imitate the Greeks;
grandin	it hails;
gravit	revolve;
greg	gather, assemble;
gubern	steer, drive, pilot, direct, manage, conduct, guide, control, govern;
gust	taste, sip; have some experience of; enjoy;
gyps	cover with gypsum;
gyr	go around/about (thing); turn/wheel around/in a circle;
habilit	enable; make suitable;
habit	inhabit, dwell; live, stay;
habitu	habituate, bring into condition/habit (body); (PASS) be conditioned/in habit;
haesit	stick hesitate, be undecided; be stuck;
halit	breathe;
hal	emit (vapor, etc); be fragrant;
hebet	blunt, deaden, make dull/faint/dim/torpid/inactive (light/plant/senses), weaken;
heredit	inherit;
hibern	spend the winter; be in winter quarters;
hiem	winter, pass the winter, keep winter quarters; be wintry/frozen/stormy;
hilar	cheer, gladden; give cheerful appearance to;
hi	be wide open, gape; be greedy for; be open-mouthed (with astonishment, etc);
hisc	(begin to) open, gape; open the mouth to speak;
honorific	honor; do honor to; confer honor;
honor	respect, honor;
horripil	become bristly/hairy; be shaggy (L+S); shudder/shake (Sou); pierce (Douay);
human	make human; (in PASSIVE of the incarnation of Christ);
humect	moisten;
humili	humble; abase; humiliate (Def);
hum	inter, bury;
hymniz	sing hymns; worship in song;
hypnotiz	hypnotize;
hypothec	mortgage;
identific	identify;
idololatri	worship an idol;
ignor	not know; be unfamiliar with; disregard; ignore; be ignorant of;
illabor	work (at); (w/DAT);
illaque	take in a snare; ensnare, entangle;
illatebr	hide in a corner;
illatr	bark;
illect	entice, attract, allure;
illig	bind, fasten, tie up;
illumin	illuminate; color;
illumin	illuminate, give light to; light up; reveal/throw light on; brighten (w/color);
illustr	illuminate, light up; give glory; embellish; make clear, elucidate; enlighten;
immigr	move (into);
immol	sacrifice, offer (victim) in sacrifice; sprinkle with sacred meal; immolate;
immortalific	immortalize;
immurmur	murmur, mutter (at or to);
immut	change, alter, transform;
imperit	command, govern;
imper	order, command, levy; rule (over) (w/DAT);
impetr	obtain/procure (by asking/request/entreaty); succeed/achieve/be granted; obtain;
impingu	fatten, make fat/sleek; become fat/thick; anoint (with oil) (Douay);
impi	render impervious; stain with sin;
implacit	implead; be pleaded against;
implan	deceive, delude; lead astray;
implant	implant; put in; add; plant; establish;
implic	implicate; involve/engage/entangle/embroil; interweave/fold/twine w/itself;
implic	|entwine/enfold/envelop/encircle; wrap up inside; embrace; enclose; hem in;
implic	||interweave/interlace/intertwine; clasp/grasp (L+S); unite/join/mix;
implic	|||perplex/confuse/confound/complicate; take hold (disease);
implic	||||(PASS) be intimately associated/connected/related/bound; be a tangle/maze;
implic	implicate; involve/engage/entangle/embroil; interweave/fold/twine w/itself;
implic	|entwine/enfold/envelop/encircle; wrap up inside; embrace; enclose; hem in;
implic	||interweave/interlace/intertwine; clasp/grasp (L+S); unite/join/mix;
implic	|||perplex/confuse/confound/complicate; take hold (disease);
implic	||||(PASS) be intimately associated/connected/related/bound; be a tangle/maze;
implor	appeal to, invoke; beg, beseech, implore; ask for help/favor/protection;
import	bring in, convey; import; bring about, cause;
impraegn	impregnate; make pregnant;
imprison	imprison;
improb	disapprove of, express disapproval of, condemn; reject;
improper	blame (person); reproach (with), taunt, upbraid (L+S);
improper	hasten into, enter hastily;
impugn	fight against, attack, assail;
imput	charge, enter as debt/credit; take into account; impute, ascribe; lay to charge;
imput	|claim credit/recompense for; make a favor a cause for obligation;
inaedific	build (in a place); wall up;
inaequ	make equal; make level; make even (L_S);
inaestu	rage;
inalb	whiten; brighten;
inamaric	embitter;
inambul	walk up and down;
inargent	overlay with silver;
inar	plow in; cultivate;
inaugur	take omens by the flight of birds; consecrate by augury;
inaur	gild, make rich;
incant	sing; say over; consecrate with spells;
incapacit	bridle; put a halter on; halter, muzzle (L+S); fetter, entangle; make ass of;
incarcer	imprison, incarcerate, confine, shut up in prison, jail;
incardin	incardinate; become member of diocese (clergy); raise to cardinal;
incarn	make incarnate, make into flesh; (PASS) be made flesh, become incarnate;
incar	make incarnate, make into flesh; (PASS) be made flesh, become incarnate;
incens	burn incense;
incept	begin; undertake; attempt;
incer	smear over; E:attach wax tablet to;
incert	render uncertain;
incest	pollute, defile;
incho	begin/start (work); set going, establish; draft/sketch/outline; enter upon;
incil	blame, scold;
inciner	burn to ashes;
incit	enrage; urge on; inspire; arouse;
inclamit	abuse; scold;
inclam	cry out (to), call upon; abuse, revile;
inclin	bend; lower; incline; decay; grow worse; set (of the sun); deject;
incoh	begin/start (work); set going, establish; draft/sketch/outline; enter upon;
incol	live, dwell/reside (in); inhabit; sojourn;
incommod	inconvenience, obstruct, hinder; be inconvenient/troublesome, cause difficulty;
inconcili	win over by trickery; embarrass;
incrass	fatten; make thick/stout;
increpit	chide, utter (noisy) reproaches at;
increp	rattle, snap, clash, roar, twang, make noise; (alarm/danger); strike noisily;
increp	rebuke, chide, reprove; protest at/indignantly, complain loudly/scornfully;
increp	rattle, snap, clash, roar, twang, make noise; (alarm/danger); strike noisily;
increp	rebuke, chide, reprove; protest at/indignantly, complain loudly/scornfully;
incrust	cover (with a layer), coat, line, daub; give an ornamental layer to, encrust;
incubit	lie upon; brood;
incub	brood; (rare alt. perf/vpar for incubo);
incub	lie in or on (w/DAT); sit upon; brood over; keep a jealous watch (over);
inculc	force upon, impress, drive home;
incumber	encumber;
incumbr	obstruct; block;
incursit	rush upon; attack;
incurs	strike/run/dash against, attack; make raids upon;
incurv	make crooked or bent; cause to bend down;
incus	accuse, blame, criticize, condemn;
indag	track down, hunt out; search out, try to find/procure by seeking; investigate;
indecor	disgrace;
indic	point out, show, indicate, expose, betray, reveal; inform against, accuse;
indubit	have misgivings (about);
indur	make hard;
induti	grant stay; E:clothe in monk's habit;
inebri	intoxicate, make drunk; saturate/drench (with any liquid);
inequit	ride upon; ride over;
inerr	wander; ramble;
inesc	entice; fill with food;
infam	bring into disrepute; defame;
infatu	make a fool of;
infelicit	make unhappy;
infelic	make unhappy;
infens	treat in a hostile manner;
infest	vex (w/attacks), harass, molest; make unsafe, disturb; infest; damage, impair;
infim	bring down to the lowest level; weaken, enfeeble; refute, invalidate, annul;
infirm	weaken; diminish; annul; (PASS) be ill (Bee);
inflamm	set on fire, inflame, kindle; excite;
infl	blow into/upon; puff out;
inform	shape, form; fashion; form an idea of;
infren	bridle;
infric	rub in;
infrigid	chill; cool;
infri	rub into; strew upon;
inful	invest/vest with mitre/episcopal insignia; put on vestments; adorn w/halo;
infusc	darken; corrupt;
ingemin	redouble; increase in intensity;
ingener	implant;
ingenicul	kneel;
ingrav	aggravate, make worse, weigh down, oppress, molest;
ingurgit	pour in liquid in a flood; engulf/plunge in; immerse in (activity); glut/gorge;
inhabilit	disqualify; incapacitate;
inhabit	dwell in, inhabit, occupy; wear (garments) (L+S);
inhaeredit	appoint an heir;
inhaered	appoint an heir;
inhal	breathe; breathe on;
inheredit	appoint an heir;
inhered	appoint an heir;
inhi	gape, be open mouthed with astonishment; covet, desire;
inhonest	disgrace;
inhonor	dishonor;
inimic	make enemies;
initi	initiate (into); admit (to) with introductory rites;
inject	apply; lay on;
injur	not to swear;
inlabor	work (at); (w/DAT);
inlag	inlaw; return to law from outlawry; reverse outlawry of person;
inlumin	illuminate, give light to; light up; reveal/throw light on; brighten (w/color);
inlustr	illuminate, light up; give glory; embellish; make clear, elucidate; enlighten;
innat	swim (in or on); swim (into); float upon;
inn	swim or float (in or on); sail (on);
innoc	harrow in;
innov	alter, make a innovation in; renew, restore; return to a thing (L+S);
inpetr	obtain/procure (by asking/request/entreaty); succeed/achieve/be granted; obtain;
inpingu	fatten, make fat/sleek; become fat/thick; anoint (with oil) (Douay);
inplan	deceive, delude; lead astray;
inplic	implicate; involve/engage/entangle/embroil; interweave/fold/twine w/itself;
inplic	|entwine/enfold/envelop/encircle; wrap up inside; embrace; enclose; hem in;
inplic	||interweave/interlace/intertwine; clasp/grasp (L+S); unite/join/mix;
inplic	|||perplex/confuse/confound/complicate; take hold (disease);
inplic	||||(PASS) be intimately associated/connected/related/bound; be a tangle/maze;
inplic	implicate; involve/engage/entangle/embroil; interweave/fold/twine w/itself;
inplic	|entwine/enfold/envelop/encircle; wrap up inside; embrace; enclose; hem in;
inplic	||interweave/interlace/intertwine; clasp/grasp (L+S); unite/join/mix;
inplic	|||perplex/confuse/confound/complicate; take hold (disease);
inplic	||||(PASS) be intimately associated/connected/related/bound; be a tangle/maze;
inprob	disapprove of, express disapproval of, condemn; reject;
inproper	blame (person); reproach (with), taunt, upbraid (L+S);
inproper	hasten into, enter hastily;
inquiet	disturb, trouble, molest, harass; press legal claim against; fidget, twiddle;
inquin	daub; stain, pollute; soil; smear;
inrig	water/irrigate; inundate/flood; refresh; wet/moisten; diffuse, shed (sensation);
inrog	impose/inflict (penalty/burden); demand/propose/call for (penalties/fines);
inrum	force receptive male oral sex; treat in a shameful manner; abuse; defile;
insec	cut/incise; make incision in; make by cutting; cut into/up (L+S); dissect;
insec	tell; tell of; relate (L+S); declare; pursue the narration;
insert	thrust in, introduce;
inserv	attend to; observe attentively;
insibil	hiss; whistle;
insimul	accuse, charge; allege;
insinu	push in, work in, creep in, insinuate;
insip	throw in;
insit	graft;
insol	place in the sun;
inson	make a loud noise; sound; resound;
inspect	look at, observe; look on, watch;
inspic	sharpen to a point;
inspir	inspire; excite, inflame; instill, implant; breathe into; blow upon/into;
instaur	renew, repeat, restore;
instig	urge on; incite, rouse;
instill	pour in drop by drop, drop in;
instimul	goad on;
inst	pursue, threaten; approach, press hard; be close to (w/DAT); stand in/on;
insud	sweat/perspire; sweat on (w/DAT); sweat at (task);
insuffl	blow/breathe in, insufflate; (w/breath of life);
insufl	blow/breathe in, insufflate; (w/breath of life);
insult	leap/jump/spring (in/on); dance/trample (on); enter with a leap;
insult	|insult; behave insultingly, mock/scoff/jeer (at); assault/attack (Latham);
insup	throw in;
insusurr	insinuate; suggest; whisper;
integr	renew; refresh; integrate (Cal);
intent	point (at); point (weapons, etc) in a threatening manner, threaten;
intercal	insert (day or month) in the calendar, intercalate; postpone;
intercurs	run in between;
interequit	ride among or between;
interme	go between; flow through;
interpell	interrupt, break in on; interpose an objection; disturb, hinder, obstruct;
interpol	furbish, vamp up; falsify;
interrog	ask, question, interrogate, examine; indict; go to law with, sue;
interspir	fetch breath; admit air;
intervall	take at intervals;
intervol	fly between; fly among;
inthroniz	enthrone;
intim	tell, tell about, relate, narrate, recount, describe;
intitul	entitle, give a name to;
inton	thunder;
inton	thunder;
intric	entangle; embarrass;
intr	enter; go into, penetrate; reach;
inumbr	cast a shadow;
inund	overflow, inundate, flood; swarm;
investig	investigate; search out/after/for; track down; find (by following game trail);
inveter	make old, give age to; grow old; become rooted;
invict	excite, exasperate, irritate;
invigil	stay awake (over); watch (over) diligently;
invit	invite, summon; challenge, incite; encourage; attract, allure, entice;
invoc	call upon, invoke; pray for;
involg	make known; publish abroad;
invol	fly into or at, rush upon; seize on;
invulg	make known; publish abroad;
ir	get/be/become angry; fly into a rage; be angry at (with DAT); feel resentment;
irradi	beam forth;
irrig	water/irrigate; inundate/flood; refresh; wet/moisten; diffuse, shed (sensation);
irrim	force receptive male oral sex; treat in shameful manner; abuse; defile; (rude);
irrit	excite; exasperate, provoke, aggravate, annoy, irritate;
irrog	impose/inflict (penalty/burden); demand/propose/call for (penalties/fines);
irror	wet with dew; besprinkle, water; rain on;
irrotul	enroll;
irrum	force receptive male oral sex; treat in shameful manner; abuse; defile; (rude);
iter	do a second time; repeat; renew, revise;
itiner	travel; go on eyre/judge's circuit;
jactit	mention; bandy; (Col);
jact	throw away, throw out, throw, jerk about; disturb; boast, discuss;
jejun	fast; abstain form;
jent	breakfast;
jocund	please, delight; feel delighted; take delight;
jubil	shout/sing out/joyfully, rejoice; invoke with/let out shouts/whoops, halloo;
jucund	please, delight; feel delighted; take delight;
Judaiz	live in the Jewish manner; keep the law, keep kosher?;
judic	judge, give judgment; sentence; conclude, decide; declare, appraise;
jug	marry; join (to);
jugul	kill by slitting the throat; butcher, kill, murder, slay; cut the throat;
jureiur	swear an oath;
jurg	quarrel, scold;
jur	swear; call to witness; vow obedience to; [jus jurandum => oath]; conspire;
justic	justify; L:bring to justice;
justific	act justly towards, do justice to; justify/make just; forgive/pardon; vindicate;
juv	it pleases/delights; it is enjoyable; it is helpful;
juv	help, assist, aid, support, serve, further; please, delight, gratify;
kal	announce, proclaim; summon, convoke, call forth/together;
labefact	shake; cause to waver; make unsteady, loosen; undermine;
lab	totter, be ready to fall; begin to sink; give way; waver, decline, sink; err;
labor	work, labor; produce, take pains; be troubled/sick/oppressed, be in distress;
lacer	mangle; slander, torment, harass; waste; destroy; cut;
lact	entice, lead on, induce; wheedle, cajole, dupe;
lacun	panel, work in panels, do paneling;
laetific	fertilize, enrich, make fruitful (land); delight, cheer, gladden, rejoice;
laicis	laicize; make lay, reduce to lay state; secularize, make (office) lay tenable;
lancin	tear in/to pieces, rend (apart), mangle;
lani	tear, mangle, mutilate, pull to pieces;
lapid	throw stones at; stone; [lapidat => it rains stones];
laps	slip, Nose one's footing;
larg	enlarge;
larv	bewitch; enchant;
lassesc	become tired, grow weary;
lass	tire, weary, exhaust, wear out;
latiniz	translate into Latin;
latin	translate into Latin;
latit	keep hiding oneself, remain in hiding, be hidden; lie low; lurk;
latr	bark, bark at;
laud	recommend; praise, approve, extol; call upon, name; deliver eulogy on;
lav	wash, bathe; soak;
lav	wash, bathe; soak;
lav	wash, bathe; soak;
lax	loosen, slaken, relax, weaken; expand, open up, extend;
lectit	read repeatedly; be in the habit of reading;
legitim	legitimize;
leg	bequeath, will; entrust, send as an envoy, choose as a deputy;
lent	bend under strain;
let	kill;
levific	smooth, make smooth; [w/linguam => deal decietfully w/tongue = lie/smooth talk];
levig	lighten; relieve;
levig	smooth, make smooth, smooth out, remove roughness; pulverize; make small (L+S);
lev	lift/raise/hold up; support; erect, set up; lift off, remove (load); comfort;
lev	|undo, take off; release, rid; free from (worry/expense); refresh/restore;
lev	||lighten, lessen, relieve; reduce in force/potency; bring down (cost/prices);
lev	|||alleviate (condition); make smooth, polish; free from hair, depilate;
liber	free; acquit, absolve; manumit; liberate, release;
libert	liberate; E:exempt;
lib	nibble, sip; pour in offering/a libation; impair; graze, touch, skim (over);
libr	balance,swing; hurl;
licenti	authorize, permit; dismiss;
lig	bind, tie, fasten; unite;
limin	illuminate, light up;
limit	bound; limit (Nelson);
lim	file; polish; file down; detract gradually from;
liqu	melt; strain;
litig	quarrel; go to law;
lit	obtain/give favorable omens from sacrifice; make (acceptable) offering (to);
loc	place, put, station; arrange; contract (for); farm out (taxes) on contract;
locuplet	enrich;
longinqu	put far off, remove to a distance; put far away from (Souter);
lucid	elucidate;
lucubr	work by lamp-light, burn the midnight oil; make or produce at night;
lumin	illuminate, give light to; light up; reveal/throw light on; brighten (w/color);
lun	make crescent-shaped, curve;
lusit	amuse oneself; play (often); play sport (Erasmus);
lutit	bedaub; bring into contempt;
lux	sprain (limb), dislocate; displace, force out of position; put out of joint;
lymph	derange, drive crazy; (PASS) be in state of frenzy;
macer	make wet/soft, soak/steep/bathe; soften; wear down, exhaust; worry, annoy/vex;
mact	magnify, honor; sacrifice; slaughter, destroy;
macul	spot; pollute; dishonor, taint;
maestific	grieve, make sad/sorrowful, sadden;
maest	grieve, make sad; afflict (L+S);
magnetiz	magnetize;
magnific	prize, esteem greatly; praise, extol;
magnufic	prize, esteem greatly; praise, extol;
mancip	transfer, sell; surrender;
mand	entrust, commit to one's charge, deliver over; commission; order, command;
manic	come in the morning; rise/set out in the morning (Souter);
manifest	make visible/clearer/evident/plain; reveal, make known; disclose; clarify;
man	flow, pour; be shed; be wet; spring;
mansit	spend the night, stay;
mansuet	tame; make tame; subdue, soften (Souter); become subdued; restrain (Vulgate);
manufest	make visible/clearer/evident/plain; reveal, make known; disclose; clarify;
margin	provide with borders;
marit	marry, give in marriage;
marl	apply clay; add marl to the soil;
mastig	whip; scourge;
matur	ripen, hurry, make haste to, hasten;
maum	meow;
medi	halve, divide in the middle; be in the middle;
melior	improve; make better;
mell	make honey; collect honey;
memor	remember; be mindful of (w/GEN/ACC); mention/recount/relate, remind/speak of;
menstru	menstruate, have period; have monthly term;
menstru	pollute; defile;
mensur	measure; estimate;
me	go along, pass, travel;
meridi	take a siesta;
mers	dip (in), immerse; overwhelm, drown;
mic	vibrate, quiver, twinkle; tremble, throb; beat (pulse); dart, flash, glitter;
migr	transport; move; change residence/condition; go away; depart; remove;
milit	serve as soldier, perform military service, serve in the army; wage/make war;
ministr	attend (to), serve, furnish; supply;
minor	reduce, make less;
mi	make water, urinate;
mirific	exalt, magnify, make wonderful;
missit	send repeatedly;
mitig	soften; lighten, alleviate; soothe; civilize;
mobilit	set in motion;
modific	limit; control; observe due measure;
moestific	grieve, make sad/sorrowful, sadden;
moest	grieve, make sad; afflict (L+S);
molest	disturb, vex, annoy, worry, trouble;
molt	punish, fine; extract as forfeit; sentence to pay;
monet	coin; mint;
monstr	show; point out, reveal; advise, teach;
mortific	kill; destroy; mortify, subdue, reduce to weakness;
mot	set in motion, shake, stir, etc;
mulc	beat up, thrash, cudgel; worst, treat roughly;
mulct	punish, fine; extract as forfeit; sentence to pay;
multiplic	multiply; repeat; increase (number/quantity/extent); have/use on many occasions;
mult	punish, fine; extract as forfeit; sentence to pay;
mund	clean, cleanse, make clean/tidy; (eccl. - ceremonially/spiritually);
murmur	hum, murmur, mutter; roar;
mussit	mutter/whisper, talk in subdued tones; keep quiet/say nothing (about);
muss	mutter/whisper (discontently); hum (bee); keep quiet (about); hem/haw; hesitate;
mutil	maim, mutilate; lop/cut/chop off, crop; cut short;
mut	move, change, shift, alter, exchange, substitute (for); modify;
narr	tell, tell about, relate, narrate, recount, describe;
nart	ski;
nat	swim; float;
natur	produce naturally;
naufrag	be shipwrecked;
nause	be sea-sick; feel sick;
nausi	be sea-sick; feel sick;
navig	sail; navigate;
nav	do with zeal; [operam navare => do one's best];
necess	render/make necessary;
nec	kill/murder; put to death; suppress, destroy; kill (plant); quench/drown (fire);
nec	kill/murder; put to death; suppress, destroy; kill (plant); quench/drown (fire);
negit	deny or refuse repeatedly;
neg	deny, refuse; say ... not;
neutraliz	neutralize;
nict	blink;
nidific	build a nest;
nigr	be black; make black;
n	swim, float;
nobilit	make known/noted/renown; render famous/notorious; ennoble; make more majestic;
nod	tie in a knot/knots;
nominit	name, term;
nomin	name, call;
noscit	recognize; be acquainted with;
not	observe; record; brand; write, inscribe;
novell	plant nurseries;
nov	make new, renovate; renew, refresh, change;
nud	lay bare, strip; leave unprotected;
numer	count, add up, reckon/compute; consider; relate; number/enumerate, catalog; pay;
nunci	announce/report/bring word/give warning; convey/deliver/relate message/greeting;
nuncup	call, name; express;
nunti	announce/report/bring word/give warning; convey/deliver/relate message/greeting;
nut	waver, give way;
obambul	walk up to, so as to meet; traverse;
obarm	arm;
obar	plow up;
obduct	lead in rivalry;
obdur	be hard, persist, endure;
obequit	ride up to;
obfirm	secure; bolt, lock, fasten, bar; be determined/inflexible; persevere in;
obfusc	darken; obscure; E:vilify;
object	expose/throw (to); throw/put in the way; lay to one's charge, put before;
objurg	scold, chide, reproach;
oblaque	dig around tree-roots; E:surround, encircle;
oblatr	bark at (+DAT or +ACC);
oblect	delight, please, amuse;
oblig	bind, oblige;
oblim	cover/fill with mud; silt up; clog;
oblin	smear over;
obliter	cause to be forgotten/fall into disuse/to disappear; assign to oblivion;
oblitter	cause to be forgotten/fall into disuse/to disappear; assign to oblivion;
obmurmur	murmur in protest (at);
obnubil	obscure, render dark/obscure; darken/cloud/fog (the mind); render unconscious;
obnunti	announce adverse omens;
obrept	creep up on, approach stealthily;
obrog	abrogate; oppose passage of law; partly repeal law;
obsatur	sate, glut;
obscur	darken, obscure; conceal; make indistinct; cause to be forgotten;
obsecr	entreat/beseech/implore/pray; (w/deity as object); [fidem ~ => beg support];
obsecund	obey, show obedience; comply with, be compliant, humor; fall in with, follow;
obser	bolt, fasten, place a bar across; bar, prohibit access to; shot off, enclose;
observit	observe; watch carefully;
observ	watch, observe; heed;
obsetric	assist in childbirth, perform the office of a midwife, provide obstetric care;
obsign	sign, seal;
obstetric	assist in childbirth, perform the office of a midwife, provide obstetric care;
obstin	be determined on;
obst	oppose, hinder; (w/DAT);
obtemper	obey; comply with the demands of; be submissive to; (w/DAT);
obtenebr	darken, make dark; obscure, conceal (Saxo);
obtrect	detract from; disparage, belittle;
obtrunc	kill; cut down;
obtur	stop up;
obumbr	overshadow, darken; conceal; defend;
obvi	meet (with dat.);
occaec	blind; blot out the light of day, darken; obscure, bury, conceal; seal/stop up;
occent	sing a serenade to; sing a lampoon against;
occlamit	cry aloud; bawl out;
occ	harrow (ground);
occub	lie (against/on top of); lie dead;
occulc	trample down;
occult	hide; conceal;
occup	seize; gain; overtake; capture, occupy; attack;
occur	occur, come about; happen;
occurs	run repeatedly or in large numbers; mob; obstruct;
offens	knock/strike against, bump into;
offer	offer; present; cause; bestow; (medieval form of offerre);
offirm	secure; bolt, lock, fasten, bar; be determined/inflexible; persevere in;
offoc	choke, throttle;
offuc	choke, throttle;
olefact	smell, sniff, perceive, detect; smell/sniff at;
olfact	smell, sniff, perceive, detect; smell/sniff at;
oner	load, burden; oppress;
opac	shade, overshadow;
oppil	stop up, block;
opprobr	taunt, reproach;
oppugn	attack, assault, storm, besiege;
oprept	creep up on, approach stealthily;
opsecr	entreat/beseech/implore/pray; (w/deity as object); [fidem ~ => beg support];
opsecund	obey, show obedience; comply with, be compliant, humor; fall in with, follow;
opstetric	assist in childbirth, perform the office of a midwife, provide obstetric care;
optemper	obey; comply with the demands of; be submissive to; (w/DAT);
opt	choose, select; wish, wish for, desire;
orb	bereave (of parents, children, etc), deprive (of);
ordin	order/arrange, set in order; adjust, regulate; compose; ordain/appoint (Bee);
organiz	organize;
orn	equip; dress; decorate, honor; furnish, adorn, garnish, trim;
or	beg, ask for, pray; beseech, plead, entreat; worship, adore;
oscit	gape; yawn;
ostent	show, display; point out, declare; disclose, hold out (prospect);
ov	rejoice;
oxyd	oxidize;
pacific	make peace, conclude peace; grant peace; pacify, appease;
pac	pacify, subdue;
paedic	commit sodomy/pederasty with, practice unnatural vice upon;
paedic	perform anal intercourse; commit sodomy with;
palific	make evident;
palli	disguise; cloak; palliate;
palpit	throb, beat, pulsate;
pampin	trim (vines);
papp	eat;
paratragoed	talk theoretically;
parent	perform rites at tombs; make appeasement offering (to the dead);
pari	acquire (accounts); settle a debt; settle up;
parit	make ready;
par	prepare; furnish/supply/provide; produce; obtain/get; buy; raise; put up; plan;
particip	share; impart; partake of; participate in;
pastin	prepare (ground) by digging and leveling;
patin	skate;
patriz	take after one's father;
patr	accomplish, bring to completion;
pauper	make poor, deprive;
paus	pause; halt; cease;
pavit	be in a state of fear or trepidation (at);
pecc	sin; do wrong, commit moral offense; blunder, stumble; be wrong;
pecc	|make mistake; make slip in speaking; act incorrectly; go wrong, be faulty;
pedic	perform anal intercourse; commit sodomy with;
peior	aggravate;
peiur	swear falsely; perjure oneself; (see also peiero);
pejer	swear falsely; swear false oath; lie;
pejur	swear falsely; swear false oath; lie;
penetr	enter, penetrate;
pensit	weigh/ponder/consider; compare (with); pay/be subject to tax; bring in income;
pens	weigh (out); pay/punish for; counterbalance, compensate; ponder, examine;
peraequ	equalize; make quite equal;
peragit	harass with repeated attacks;
peragr	travel over every part of, scour;
perambul	walk about in, tour; make the round of;
peram	persevere in love;
perar	furrow; inscribe (scratch on a waxen tablet);
percelebr	make thoroughly known;
percrep	resound; make resound;
percur	heal completely;
percurs	rove about;
percut	affect deeply;
perdol	hack, hew into shape, fashion by hewing/hacking;
perdom	tame/subdue thoroughly, break in (animals); conquer/subjugate completely;
perdom	|crush (grain)/knead (dough) thoroughly; work/break up (soil) thoroughly;
perduct	guide;
perdur	last long, endure;
perenn	last many years;
perequit	ride through; ride around;
pererr	wander through, roam or ramble over;
perfl	blow through or over;
perfluctu	flow through;
perfor	bore/pierce/make a hole/passage/break in/through; bore/pierce/stab/perforate;
perfrem	fill place with roaring/snorting sounds; snort/roar along;
perfric	rub all over; rub smooth; [~ os/frontem/facium => wipe off blush/abandon shame];
perfric	rub all over; rub smooth; [~ os/frontem/facium => wipe off blush/abandon shame];
perjur	swear falsely;
perlibr	make level;
perlit	make auspicious sacrifice;
perlustr	go or wander all through; view all over, scan, scrutinize;
perman	flow through; leak through; permeate;
permatur	become quite ripe;
perme	go or pass through, cross, traverse; pervade;
permut	exchange (for); swap;
perneg	deny completely; refuse completely;
pernoct	spend the night; occupy the night (w/person or in place); guard all night;
pernumer	count up; reckon;
perorn	adorn highly/greatly;
peror	deliver the final part of a speech, conclude;
perpac	subdue completely;
perpetr	carry through, accomplish;
perpot	drink heavily; drink up;
perpurg	purge well; clear up; explain fully;
perrept	crawl through, crawl about;
perrog	ask/question/solicit in turn; L:propose/pass a law; carry (bill);
persalut	salute/greet in turn;
persan	cure completely;
persec	dissect; cut up;
persever	persist, persevere; continue;
persign	note down; record;
personific	personify;
person	make loud/continuous/pervasive noise/loud music; ring/resound; chant/shout out;
person	make loud/continuous/pervasive noise/loud music; ring/resound; chant/shout out;
perspect	look through to end; examine closely;
perstimul	stimulate violently;
perst	stand firm; last, endure; persevere, persist in;
persult	leap or skip or prance about, range (over), scour;
pertempt	test, try out; explore thoroughly; agitate thoroughly;
pertent	test, try out; explore thoroughly; agitate thoroughly;
perterebr	bore through;
perterrit	frighten thoroughly/greatly, terrify;
pertoler	endure;
perturb	confuse, throw into confusion; disturb, perturb, trouble; alarm;
pervast	devastate completely;
pervestig	make a thorough search of; explore fully;
pervigil	remain awake all night; keep watch all night; keep a religious vigil;
pervolg	proclaim; spread abroad; (pervulo);
pervolit	flit across; fly repeatedly over/through; move rapidly through space/heavens;
pervol	fly or flit through; wing one's way; move rapidly through the air;
pervol	fly through; fly;
pervolut	roll about; be busied with;
pervulg	make publicly known, spread abroad;
pessim	ruin, debase; spoil completely, make utterly bad; harm, injure, bring calamity;
pessumd	destroy, ruin; sink, send to the bottom; put an end to; do away with, remove;
pessund	destroy, ruin; sink, send to the bottom; put an end to; do away with, remove;
phlebotom	let blood; bleed;
photocopi	photocopy;
photograph	photograph;
physicul	prophesy, foresee, divine;
pic	smear with pitch;
pil	grow hairy; depilate; plunder;
pi	appease, propitiate; cleanse, expiate;
pipil	twitter, chirp;
pipi	chirp, pipe;
placit	plead;
plac	appease; placate; reconcile;
plag	strike; wound;
plant	propagate from cuttings; set out, transplant (L+S); fix in place; form, make;
plasm	form, mold, fashion;
plegi	pledge;
plic	fold (up), bend, flex; roll up; twine/coil; wind/fold together (L+S); double up;
plic	|multiply by X (only with numerical prefix), X-tuple; add together (L+S);
plic	fold (up), bend, flex; roll up; twine/coil; wind/fold together (L+S); double up;
plipi	screech; (emit the cry of the hawk);
pl	multiply by X (only with numerical prefix), X-tuple, increase X fold;
plor	cry over, cry aloud; lament, weep; deplore;
plumb	solder, lead; make of lead;
pomp	perform with pomp;
ponder	weigh; weigh up;
port	carry, bring;
postput	consider less important; disregard;
postul	demand, claim; require; ask/pray for;
potion	give to drink;
potit	drink;
pot	drink; drink heavily/convivially, tipple; swallow; absorb, soak up;
pot	drink; drink heavily/convivially, tipple; swallow; absorb, soak up;
praeambul	walk before; precede;
praeceler	hasten before;
praecell	surpass; excel;
praecent	sing consolation for;
praecipit	throw headlong, cast down;
praecontrect	pre-consider; feel in advance;
praedelass	weary beforehand;
praedestin	predestine, predetermine, determine beforehand; provide beforehand;
praedetermin	fix beforehand;
praedic	proclaim/declare/make known/publish/announce formally; praise/recommend; preach;
praedivin	pre-divine; divine in advance;
praedur	harden; make very hard;
praefestin	be too hasty; hurry past;
praeflor	deprive of blossoms; diminish, lessen;
praefoc	choke, suffocate;
praegrav	weigh down, burden;
praegust	taste in advance;
praejudic	prejudge; decide beforehand;
praejuv	aid before; give aid previously;
praeleg	pre-bequeath; bequeath before inheritance is divided;
praelig	pre-bind; tie around; tether;
praemand	pre-order;
praememor	mention first;
praemic	glitter forth;
praeministr	attend to; minister to;
praenarr	tell beforehand;
praenat	swim by; flow by;
praenavig	sail along; sail past;
praenot	mark before; note down; predict; L:entitle;
praenunti	announce in advance;
praeoccup	seize upon beforehand; anticipate;
praeopt	prefer;
praepar	prepare;
praeponder	outweigh; be of more weight;
praeport	carry before;
praeputi	drawing out the foreskin/prepuce;
praeradi	outshine;
praerog	ask first; pay in advance;
praesec	cut in front, cut;
praesent	present (to mind/senses), exhibit (to view), show (oneself); hold out; hand to;
praest	it is better;
praestin	buy; purchase;
praest	excel, surpass, be outstanding/superior/best/greater/preferable (to); prevail;
praest	|furnish/supply, make available, hand over; tender/offer/present; play part;
praest	||apply, bring to bear; fulfill, make good; keep word; be responsible for;
praest	excel, surpass, be outstanding/superior/best/greater/preferable (to); prevail;
praest	|furnish/supply, make available, hand over; tender/offer/present; play part;
praest	||apply, bring to bear; fulfill, make good; keep word; be responsible for;
praesult	dance/leap before/in front of;
praetempt	pre-test, try out in advance; feel/search/grope out beforehand;
praetent	allege; hold out as a reason;
praeternavig	sail by;
praetervol	fly past; slip by;
praetrepid	be hasty or impatient;
praetrunc	cut off; clip;
praeviti	precorrupt; corrupt in advance;
praevol	fly before;
prav	misrule; be crooked/bad/vicious/evil/corrupt; bend;
preexist	pre-exist; be previously;
prehens	grasp/clutch at/constantly; lay hold of; accost/buttonhole; canvass, solicit;
prens	grasp/clutch at/constantly; lay hold of; accost/buttonhole; canvass, solicit;
press	press, squeeze;
principi	begin to speak; begin to peak (medieval);
priv	deprive, rob, free;
prob	approve (of), esteem/commend/recommend/certify; give assent/approval/sanction;
prob	|let; show to be real/true; examine/test/try/prove/demonstrate; get accepted;
proclam	call/cry out, raise an outcry; appeal noisily; take claim to court; proclaim;
proclin	tilt forward; cause to totter;
procrastin	put off till the next day, postpone; delay;
procre	bring into existence, beget, procreate; produce, create;
procub	lie outstretched;
proculc	trample on;
procur	manage; administer; attend to;
procurs	run frequently forward, dash out;
prodeambul	take a walk;
product	prolong; throw before, interpose;
profan	desecrate, profane;
proflig	overthrow, rout;
profl	blow out, exhale;
progener	engender, produce;
programm	program (data processing);
prolat	lengthen, enlarge; prolong; put off, defer;
prolect	lure, entice;
prolix	extend in space; elongate;
prolong	prolong, extend, lengthen;
promon	emanate;
prompt	distribute widely;
promulg	make known by public proclamation; publish;
pronunti	announce; proclaim; relate; divulge; recite; utter;
propag	propagate; extend, enlarge, increase;
propal	stake out (like a plant); make visible/manifest;
proper	hurry, speed up; be quick;
prophetiz	prophesy, foretell, predict;
prophet	prophesy, foretell, predict;
propin	drink to anyone (his health), pledge; give to drink; hand over, yield up; make;
propinqu	bring near; draw near;
propiti	propitiate, render favorable, win over; sooth (feelings);
propugn	fight (on the defensive);
propuls	repulse, drive back/off; ward off, repel, avert; pound, batter;
prorit	prove, cause; incite; tempt;
prorog	prolong, keep going; put off, defer;
prospect	gaze out (at); look out on;
prosper	cause to succeed, further;
prost	offer goods for sale to public; be on sale, expose for sale/prostitute oneself;
protel	drive/cause to retreat before one; drive forth, hound out, rout; beat back/off;
protuber	swell/bulge out; grow forth; stand out (Sax);
proturber	bulge/swell out; grow forth; stand out (Sax); be prominent, project;
proturb	drive/push away/out of the way; drive out in confusion; repulse; pitch forward;
provoc	call forth; challenge; provoke;
provol	fly forward; dash forth;
provulg	publish; make known;
proxim	come/draw near, approach; be near;
public	confiscate; make public property; publish;
pugil	box;
pugn	fight; dispute; [pugnatum est => the battle raged];
pullul	sprout, send forth new growth; spring forth;
puls	beat; pulsate;
pult	knock, strike;
pulveriz	pulverize;
pumic	polish/rub smooth with pumice stone; (esp. book);
purg	make clean, cleanse; excuse;
purific	purify/make ceremonially/ritually pure; clean/clear; free of dirt/encumbrances;
put	think, believe, suppose, hold; reckon, estimate, value; clear up, settle;
pytiss	spit out wine; to spit out wine after tasting;
quadr	square up, make square/suitable; square/fit; quadruple; form rectangular shape;
quadruplic	quadruple; multiply by four;
quaerit	seek, search for;
qualific	qualify, invest with a quality/qualities;
quass	shake repeatedly; wave, flourish; batter; weaken;
quinquiplic	multiply by five;
radic	take root; grow roots;
rapt	drag violently off; ravage;
rasit	shave (off) habitually;
ratific	ratify;
rationaliz	rationalize;
rebell	rebel, revolt;
rebo	resound, re-echo; bellow back; call/cry in answer;
recalcitr	be disobedient; P:deny access;
recant	charm away/back; withdraw, recall, revoke, recant;
recapitul	recapitulate, go over the main points again;
recept	recover; receive, admit (frequently);
reciper	restore, restore to health; refresh, recuperate;
reciproc	move backwards and forwards; (w/animam) to breathe;
recit	read aloud, recite; name in writing;
reclamit	reproclaim; proclaim against;
reclam	cry out in protest at;
reclin	bend back; [se reclinare => lean back, recline];
recogit	consider, reflect, think over; examine, inspect;
recompens	repay/recompense; compensate for misdeed/wrong; make up for injury/loss; reward;
reconcili	restore; reconcile;
reconcinn	repair; set right;
reconfl	rekindle;
recre	restore, revive;
recrep	sound in answer, resound;
rectific	rectify, regulate, control, govern/direct by rule/regulation;
recub	lie down/back, recline, lie on the back;
recuper	regain, restore, restore to health; refresh, recuperate;
recur	cure, restore, refresh;
recurs	keep rebounding/recoiling; keep recurring to the mind;
recurv	bend back;
recus	reject, refuse, refuse to; object; decline;
redambul	come back;
redam	love back; love in return;
redauspic	retake auspices;
redhal	exhale;
redintegr	renew; revive;
redon	give back again; forgive;
redund	overflow; be too numerous;
reflagit	redemand;
refl	blow back again;
refocill	revive, revivify; warm to life again; relieve (Ecc);
refocil	revive, revivify; warm to life again; relieve (Ecc);
reformid	dread; shun; shrink from; recoil at the sight of;
reform	transform, remold; form (new shape); restore;
refren	curb, check; restrain;
refric	gall; excite again;
refriger	make cool;
refut	check; refute;
reglutin	unstick; rejoin;
regn	reign, rule; be king; play the lord, be master;
regust	retaste; taste again;
reject	throw back;
relax	loosen, widen; relax;
releg	banish, remove; relegate;
relev	relieve/alleviate/diminish/lighten; ease/refresh; exonerate; raise; lift (eyes);
relig	tie out of the way; bind fast; moor;
reman	flow back;
reme	go or come back, return;
remig	row, use oars;
remigr	move back; return;
remurmur	remurmur; murmur back;
renarr	tell over again;
renavig	sail back;
renod	bind back; tie back;
renov	renew, restore; revive;
renumer	repay, pay back; pay out (that owed); report count of;
renunci	report, announce; reject; (also renuntio);
renunti	report, announce; reject;
renut	refuse; decline;
repar	prepare again; renew, revive;
reped	return, go back; retire;
replegi	bail (person); recover security taken for court appearance;
replic	turn/fold/bend back (on); unroll (scroll); unwind (cable); go over and over;
replic	repeat; turn/fold/bend back (on); unroll, unwind; go over and over;
report	carry back; report;
repraesent	represent, depict; show, exhibit, display; manifest; pay down, pay in cash;
reprehens	blamer; critic;
reprob	condemn; reject;
rept	crawl/creep (over); move slowly/lazily/furtively, stroll/saunter, slink, grope;
repudi	reject; repudiate; scorn;
repugn	fight back, oppose; be incompatible with; disagree with;
repuls	drive back; reject;
repu	reject;
repurg	recleanse; clear again; purge away;
reput	think over, reflect;
requirit	inquire repeatedly; keep asking after;
resacr	implore again and again; free from a curse;
resalut	greet back; greet in return;
resec	cut back, trim; reap, cut short;
resecr	implore again and again; free from a curse;
resemin	reproduce;
reser	open up, unseal, unbar (gate/door), unfasten; make accessible; uncover, expose;
reserv	reserve; spare; hold on to;
resign	unseal; open; resign;
reson	resound;
respect	keep on looking round or back; await; have regard for;
respir	breathe out; take breath; enjoy a respite;
responsit	give advice;
respons	answer, reply (to); reecho;
restagn	overflow; be covered with flood-water;
rest	it remains to; it remains standing;
restaur	restore (condition); rebuild; bring back, re-establish, take up again; renew;
restit	stay behind; hesitate;
rest	stand firm; stay behind; be left, be left over; remain;
result	reverberate, resound; re-echo; rebound, spring back;
resuscit	rouse again, reawaken;
retard	delay, hold up;
retempt	reattempt; try again; (=retento);
retent	hold fast/back, keep hold of; restrain/detain, keep in check/place; retain;
reton	thunder back;
retract	undertake anew; draw back, be reluctant; reconsider; withdraw;
retrect	undertake anew; draw back, be reluctant; reconsider; withdraw; (= retracto);
revel	show; reveal;
reverber	beat back; repel (violently from a surface);
revoc	call back, recall; revive; regain;
revol	fly back;
rig	moisten, wet, water, irrigate;
robb	rob;
robor	give physical/moral strength to; reinforce; strengthen, make more effective;
rogit	ask, inquire;
rog	ask, ask for; invite; introduce;
ror	cause dew, drip; be moist;
rot	whirl round; revolve, rotate;
rotund	make round, give circular/spherical shape to; round off (sum);
rug	wrinkle, crease; corrugate; become wrinkled/rumpled/creased;
rumific	report;
runcin	plane (as a carpenter);
runc	weed, thin out;
rutil	redden, make reddish; have a reddish glow;
rutund	make round, give circular/spherical shape to; round off (sum);
sabbatiz	observe/keep the sabbath;
sacc	filter; strain;
sacrific	sacrifice; celebrate the Mass (Erasmus);
sacr	consecrate, make sacred, dedicate;
sagin	fatten (animals) for eating; feed lavishly, stuff;
sagitt	shoot arrows;
saltit	dance a lot; dance vigorously;
salt	dance, jump; portray or represent in a dance;
salut	greet; wish well; visit; hail, salute;
salvific	save, deliver;
salv	save;
sanctific	sanctify, treat as holy;
san	cure, heal; correct; quiet;
sati	satisfy, sate; nourish;
satur	fill to repletion, sate, satisfy; drench, saturate;
sauci	wound, hurt; gash, stab;
scandaliz	tempt to evil; cause to stumble; offend, scandalize (Bee);
scariph	scratch open; scarify; (L+S gives scarifo, JFW's texts have -ph-);
sceler	defile;
scintill	send out sparks;
scirp	plait/make (baskets, etc.) from bulrushes;
scirt	dance; (4 Ezra 6:21);
sclopet	fire rifle;
scop	brush/sweep away;
scre	clear the throat, hawk, hem;
scriptit	write often; compose;
script	write; compose;
sec	cut, sever; decide; divide in two/halve/split; slice/chop/cut up/carve; detach;
sec	cut, sever; decide; divide in two/halve/split; slice/chop/cut up/carve; detach;
secub	sleep apart from one's spouse or lover; sleep alone; live alone;
seculiz	live a worldly life;
secund	make conditions favorable (winds/deities), favor; adjust, adapt; prosper;
sed	settle, allay; restrain; calm down;
segreg	remove, separate;
semigr	go away;
semin	plant, sow;
sensific	sensitize;
sententi	decree; L:pronounce sentence;
separ	divide, distinguish; separate;
sequestr	sequestrate, place/surrender into hands of trustee; separate, remove (L+S);
seren	clear up, brighten; lighten;
sermoniz	preach;
serr	saw; saw up, saw into pieces;
serv	watch over; protect, store, keep, guard, preserve, save;
sessit	sit for long;
sevoc	call aside; remove; separate;
sexquartan	increase by a quarter;
sexquintan	increase by a fifth;
sexquintern	increase by a fifth;
sibil	hiss; hiss at;
sicc	dry, drain; exhaust;
sigill	seal; seal-up; confirm; (DEP form also known);
signific	signify, indicate, show;
sign	mark, stamp, designate, sign; seal;
simil	imitate, copy; pretend (to have/be); look like; simulate; counterfeit; feint;
simplific	simplify;
simul	imitate, copy; pretend (to have/be); look like; simulate; counterfeit; feint;
singult	catch the breath, gasp; hiccup; sob, utter with sobs; gasp out (one's life);
sinu	bend into a curve; bend; billow out;
sip	throw; pour; strew, scatter; (usu. only in compounds);
sirp	plait/make (baskets, etc.) from bulrushes;
smalt	enamel;
soci	unite, join, ally; share in;
solid	make solid/whole/dense/firm/crack free; strengthen, consolidate; solder; knit;
solit	to make it one's constant habit to (w/INF); make a practice of; be accustomed;
sollemniz	celebrate; solemnize;
sollicit	disturb, worry; stir up, arouse, agitate, incite;
somni	dream; dream of or see in a dream;
son	make a noise/sound; speak/utter, emit sound; be spoken of (as); express/denote;
son	|echo/resound; be heard, sound; be spoken of (as); celebrate in speech;
sopor	rend to sleep, render unconscious, stupefy;
sorbill	sip;
sospit	preserve, defend;
spect	observe, watch, look at, see; test; consider;
sper	hope for; trust; look forward to; hope;
spic	furnish with spikes; provide ears;
spicul	stab;
spin	crown with thorns; prick;
spir	breathe; blow; live; breathe out; exhale; breathe the spirit of;
spiss	thicken, condense;
spoli	rob, strip; despoil, plunder; deprive (with abl.);
spons	become betrothed/engaged to marry (woman); espouse, affiance (L+S);
spum	foam, froth; be covered in foam; cover with foam;
spurc	soil, infect; deprave;
sput	spit out;
stabul	stable/house (domestic animals, poultry, etc); be housed, have stall/lair/den;
stagn	form/lie in pools; be under water;
stell	set/furnish/cover with stars/points of light;
stercor	void excrement, defecate;
steriliz	sterilize;
sternut	sneeze (repeatedly or violently);
still	fall in drops; drip; cause to drip; pour in drops;
stimul	urge forward with a goad, torment,sting; incite, rouse to frenzy;
stip	crowd, press together, compress, surround closely;
st	stand, stand still, stand firm; remain, rest;
strangul	strangle/throttle; suffocate/stifle/smother; choke; constrict way; keep close;
strepit	make a loud or harsh noise;
strig	halt, stop;
stri	provide with channels; groove; wrinkle;
stupr	have (illicit) sexual intercourse with;
subaccus	blame somewhat;
subarrh	pledge, pay earnest money; espouse, undertake;
subass	roast a little;
subauscult	listen secretly; eavesdrop;
subfur	steal unobtrusively; steal away;
subigit	behave improperly to; work upon, incite;
subintr	go into secretly, enter by stealth;
subinvit	invite vaguely;
subject	throw up from below; apply below;
subjug	subjugate, make subject; bring under the yoke (L+S);
sublect	coax;
sublev	lift up, raise; support; assist; lighten;
sublig	fasten (to);
sublim	raise, place in elevated position; soar; send up (spirits) from underworld;
subministr	supply, furnish, afford;
submurmur	murmur softly;
submut	exchange;
subneg	refuse somewhat; deny somewhat;
subnervi	hamstring; (cut sinew in leg); invalidate (L+S); refute;
subnerv	hamstring; (cut sinew in leg); invalidate (L+S); refute;
subnot	subscribe;
sub	be in heat;
subodor	suspect;
suborn	equip, adorn;
subpur	suppurate, fester under the surface;
subremig	make rowing movements underneath;
subrog	elect/propose/nominate/cause to be elected as successor/substitute; substitute;
subsann	mock, deride; insult by derisive gestures; sneer;
subsec	cut away below; pare (the nails);
subsili	jump/leap/spring up; plunge beneath;
subst	hold firm; stand under;
subsult	keep jumping up; spring up, leap up; (also jerky rhythm);
subvect	convey (often or laboriously) upwards;
subvent	bring aid; come quickly to assistance;
subvol	fly upwards;
succenturi	substitute; place in reserve;
succlam	shout in response (to);
succoll	lift/carry on one's shoulders;
sud	sweat, perspire;
suffarcin	stuff, cram;
suffl	blow/puff up, inflate; blow; get into a temper with;
suffoc	strangle, choke, suffocate;
suffric	rub-down; rub-off;
suffumig	fumigate from below;
suffur	steal unobtrusively; steal away;
suggill	insult, humiliate;
sugill	insult, humiliate;
sulc	furrow, plow; cleave;
sumministr	supply, furnish, afford;
summurmur	murmur softly;
summut	exchange;
superabund	be very abundant;
superaedific	build upon/over;
superd	lay over; put over; apply on the surface;
superexalt	exalt above others;
supernat	swim on top; float;
super	overcome, conquer; survive; outdo; surpass, be above, have the upper hand;
superoccup	take by surprise from above;
superoner	overload with fetters;
superst	stand on top (of) (w/DAT/ABL); stand over (someone prostrate or recumbent);
supervolit	fly to and fro over;
supervol	fly over;
supin	lay on the back; turn up; tilt back;
sup	throw; pour; strew, scatter; (usu. only in compounds);
suppedit	be/make available when/as required, supply with/needs (of);
suppil	steal; pilfer;
supplant	trip up;
supplic	pray, supplicate; humbly beseech;
support	carry up, transport;
suppullul	spring up secretly;
suppur	suppurate, fester under the surface;
supput	count up, compute;
surrog	replace; depute;
suscit	encourage, stir up; awaken, rouse, kindle;
suspect	suspect; mistrust, be suspicious of; suspect the presence of evil; gaze up at;
suspir	sigh; utter with a sigh;
sussult	keep jumping up; spring up, leap up; (also jerky rhythm);
sustent	endure, hold out;
susurr	mutter, whisper, hum, buzz, murmur;
syllogiz	reason syllogistically;
symboliz	symbolize; accord, correspond;
synchroniz	synchronize;
syncop	faint, suffer a syncope/fainting fit;
tard	check, retard; hinder;
tax	value, assess the worth of; access a crime; reckon the size/extent; fix sum of;
telegraph	telegraph;
telephon	phone;
temer	violate; defile, pollute; violate sexually;
temper	combine, blend, temper; make mild; refrain from; control oneself;
tempt	test, try; urge; worry; bribe;
tenebr	darken, make dark;
tent	handle, feel; attempt, try; prove; test; attack; brave; make an attempt;
tenu	make thin; reduce, lessen; wear down;
terebr	bore through, drill a hole in;
termin	mark the boundaries of, form the boundaries of; restrict; conclude;
terrific	terrify;
territ	intimidate; keep on frightening;
terti	repeat three times;
thermopot	drink warm; refresh with warm drinks;
thesauriz	gather up treasure; lay up treasure; hoard;
tine	be infested with moths; (or maggots/larvae of moths which do the eating/damage);
tintinn	make a ringing or jangling sound;
tintin	make a ringing or jangling sound;
titill	tickle, titillate, provoke; stimulate sensually;
titi	tweet; (song of the sparrow);
titub	stagger, totter; falter;
toler	bear, endure, tolerate;
ton	it thunders;
ton	thunder; speak thunderous tones/thunderously; make/resound like thunder;
torment	torture; torment; inflict acute physical/mental pain;
torn	turn, make round by turning on a lathe; round off (L+S); turn, fashion, smooth;
tort	torture; torment;
tract	draw, haul, pull, drag about; handle, manage, treat, discuss;
tran	swim across;
tranquill	calm, quiet;
transfigur	transform, change form/appearance;
transform	change in shape, transform;
transfor	pierce through;
transfret	cross a strait; pass over the sea; put/ferry across; pass through;
translat	offer; transfer;
transme	go across, cross, travel across; pass over;
transmigr	change one's residence from one place to another; transport; spread (disease);
transmut	change about;
transnat	swim across;
transnavig	sail over;
transn	swim across, sail across; swim to the other side;
transnomin	rename;
transpit	pass through;
transplant	transplant; remove;
transport	carry across, transport;
transult	spring across;
transverber	transfix;
transvers	pass across one from side to side;
transvolit	fly over or through;
transvol	fly across;
transvor	gulp down;
trepid	tremble, be afraid, waver;
trestorn	put to flight;
treutin	balance, weigh;
tribul	press, squeeze; exact (dues/payment); trouble;
triplic	triplicate/do three copies; L:surrejoin/plaintiff reply to defendant rejoinder;
tripod	dance; perform ritual dance (in triple time in honor of Mars);
tripudi	dance; perform ritual dance (in triple time in honor of Mars);
tristific	make sad, cause sadness, sadden;
tritur	thresh;
triumph	triumph over; celebrate a triumph; conquer completely, triumph;
trucid	slaughter, butcher, massacre;
trucil	trill; (song of the thrush);
trunc	maim, mutilate; strip of branches, foliage; cut off;
trusit	push often; keep pushing;
trus	push often; push strongly;
trutin	balance, weigh;
tudit	strike often;
tuiss	be familiar with;
tumul	cover with a burial mound;
turbid	disturb/trouble/agitate; make turbulent/turbid; obscure, make turmoil/confusion;
turb	disturb, agitate, throw into confusion;
turp	make ugly; pollute, disfigure;
ulcer	cause to fester;
ulul	howl, yell, shriek; celebrate or proclaim with howling;
umbr	cast a shadow on, shade;
umect	moisten, make wet;
unctit	anoint often;
und	surge/flood/rise in waves; gush/well up; run, stream; billow; undulate; waver;
unific	unify;
urc	urk; (verbal expression of the cry of the lynx);
ustil	scorch, char, burn partially; frost nip; cause to smart/tingle;
ustul	scorch, char, burn partially;
usurp	seize upon, usurp; use;
utlag	outlaw;
uxorcul	play the part of a wife;
vacill	stagger, totter; be in a weak condition;
vac	be empty; be vacant; be idle; be free from, be unoccupied;
vacu	empty;
vadi	fight (a duel);
vadi	pledge (to meet debt);
vall	surround/fortify/furnish (camp, etc) with a palisaded rampart;
vapor	cover or fill with vapor; heat, warm; be hot;
vapul	be beaten;
varic	straddle (with legs apart);
vari	mark with contrasting colors, variegate; vary, waver; fluctuate, change;
vast	lay waste, ravage, devastate;
vect	transport, carry; (of habitual agent/means); (PASS) ride, be conveyed, travel;
veget	invigorate; impart energy to;
vellic	pinch, nip; criticize carpingly;
vel	veil, cover, cover up; enfold, wrap, envelop; hide, conceal; clothe in;
vendic	claim, vindicate; punish, avenge; (alternative spelling of vindico);
vendit	offer for sale; cry up; pay court (to);
venen	imbue or infect with poison; injure by slander;
ventil	expose to a draught; fan; brandish;
ventit	keep coming; come regularly, come often; resort (to);
venumd	sell; offer for sale;
venund	sell; offer for sale;
venust	make lovely/attractive; beautify; adorn;
verber	beat, strike, lash;
verfic	verify, confirm the truth/authenticity of; show to be true by evidence;
verific	verify, confirm the truth/authenticity of; show to be true by evidence;
vermin	have worms; have itching;
vern	carry on or undergo the process proper to spring;
versific	write verse;
vestig	track down, search for; search out; try to find out by searching; investigate;
veter	make old; age;
vet	forbid, prohibit; reject, veto; be an obstacle to; prevent;
vet	forbid, prohibit; reject, veto; be an obstacle to; prevent;
vex	shake, jolt, toss violently; annoy, trouble, harass, plague, disturb, vex;
vibr	brandish, wave, crimp, corrugate; rock; propel suddenly; flash; dart; glitter;
victim	offer (victim/animal) for sacrifice;
vidu	widow; bereave of a husband;
vigil	remain awake, be awake; watch; provide for, care for by watching, be vigilant;
vigor	animate; invigorate; gain strength;
vilic	perform duties of farm overseer; act as overseer of estate/public property;
villic	perform duties of farm overseer; act as overseer of estate/public property;
vindemi	gather/harvest grapes (for wine); gather grapes with which to make (wine);
vindic	claim, vindicate; punish, avenge;
viol	violate, dishonor; outrage;
visc	smear; glue; make sticky;
visit	visit, call upon; see frequently/habitually;
vitilitig	brawl; guard;
viti	make faulty, spoil, damage; vitiate;
vit	avoid, shun; evade;
vitre	glaze;
vituper	find fault with, blame, reproach, disparage, scold, censure;
vivific	bring back to life; make live;
vocit	call;
voc	call, summon; name; call upon;
volg	spread around/among the multitude; publish, divulge, circulate; prostitute;
volit	fly about, hover over;
volner	wound/injure/harm, pain/distress; inflict wound on; damage (things/interest of);
vol	fly;
volut	roll, wallow, turn over in one's mind, think or talk over;
vomit	vomit frequently or continually;
vor	swallow, devour;
vot	forbid, prohibit; reject, veto; be an obstacle to; prevent;
vulg	spread around/among the multitude; publish, divulge, circulate; prostitute;
vulner	wound/injure/harm, pain/distress; inflict wound on; damage (things/interest of);
warantiz	warrant;
zel	love ardently; be jealous of (L+S); be serious about;
zinzi	zinzie; (expressing the sound made by a blackbird);
